feedback:   abcdefk
february:   abefruy
medical:   acdeilm
calendar:   acdelnr
michael:   acehilm
archive:   acehirv
chapter:   acehprt
article:   aceilrt
american:   aceimnr
practice:   aceiprt
central:   acelnrt
compare:   acemopr
corporate:   aceoprt
location:   acilnot
political:   acilopt
privacy:   aciprvy
company:   acmnopy
reading:   adeginr
florida:   adfilor
holiday:   adhiloy
additional:   adilnot
individual:   adilnuv
learning:   aegilnr
magazine:   aegimnz
agreement:   aegmnrt
germany:   aegmnry
another:   aehnort
material:   aeilmrt
entertainment:   aeimnrt
private:   aeiprtv
payment:   aemnpty
original:   agilnor
quality:   ailqtuy
journal:   ajlnoru
building:   bdgilnu
problem:   belmopr
november:   bemnorv
include:   cdeilnu
included:   cdeilnu
director:   cdeiort
including:   cdgilnu
product:   cdoprtu
collection:   ceilnot
experience:   ceinprx
picture:   ceiprtu
project:   cejoprt
complete:   celmopt
function:   cfinotu
country:   cnortuy
different:   definrt
delivery:   deilrvy
provide:   deioprv
provided:   deioprv
kingdom:   dgikmno
profile:   efilopr
network:   eknortw
following:   fgilnow
working:   giknorw
