abcdefk:   feedback
abcdefr:   barefaced
abcdehl:   bleached
abcdehr:   breached
abcdehu:   debauched, debauch
abcdein:   abidance
abcdeir:   carbide, barricaded, barricade
abcdeit:   diabetic, abdicated, abdicate
abcdekl:   blacked, blackballed
abcdekn:   backbend
abcdekp:   backpacked
abcdekr:   barracked
abcdekt:   backdated, backdate
abcdelm:   becalmed
abcdeln:   danceable, balanced
abcdelo:   caboodle
abcdelr:   clabbered
abcdelt:   detectable, delectable
abcdelu:   educable
abcdemr:   embraced, cambered
abcdenu:   abundance
abcdeor:   brocaded, brocade
abcdert:   cerebrated, acerbated
abcderu:   barbecued
abcdetu:   abducted
abcdhkn:   backhand
abcdhkr:   hardback
abcdilo:   diabolical, diabolic
abcdilr:   birdcall, baldric
abcdimo:   cambodia
abcdirt:   catbird
abcdkor:   backboard
abcdkrw:   drawback, backward
abcdkry:   backyard
abcdlry:   barclaycard
abcdruy:   cadbury
abcefin:   beneficia
abcefit:   beatific
abcegir:   ribcage, cribbage
abcegkl:   blackleg
abcegor:   brocage
abcegot:   cabotage
abcehir:   hebraic
abcehit:   bathetic
abcehkl:   checkable
abcehlm:   bechamel
abcehln:   blanche
abcehlr:   reachable, bleacher
abcehlt:   teachable, attachable
abcehlw:   chewable
abcehly:   bellyache
abcehmr:   chamber
abcehmt:   macbeth
abcehrw:   beachwear
abceikt:   backbite
abceilm:   climbable, amicable, alembic
abceiln:   inclinable, binnacle
abceilo:   illocable
abceilp:   applicable
abceilr:   caliber, balearic
abceilt:   celibate
abceily:   celibacy
abceimn:   ambiance
abceinr:   caribbean, carbine
abceint:   cabinet
abceior:   aerobic
abceiot:   iceboat
abceirt:   beatrice, bacteria
abcejno:   jacobean
abceklm:   clambake
abcekln:   blacken
abceklo:   lockable
abceklr:   blacker
abcekmn:   beckman
abcekmo:   comeback
abcekno:   backbone
abceknr:   breakneck, bracken
abcekpr:   paperback, backpacker
abcekrt:   bracket
abcektw:   wetback
abcelmp:   campbell
abcelmr:   mercable, clamber
abcelnr:   barnacle
abcelnu:   unbalance
abcelop:   placebo
abcelor:   colorable, barcarole, albacore
abcelot:   locatable, collectable
abcelpr:   replaceable
abcelpt:   acceptable
abcelpu:   culpable
abcelpy:   peaceably
abcelrt:   tractable, traceable, retractable, retraceable, celebrate, bracelet
abcelru:   curable, accruable
abcelrx:   execrable
abcelry:   recyclable
abcelwy:   cableway
abcemnr:   remembrancer, remembrance
abcemrt:   camembert
abcemry:   embracery
abcenrt:   cabernet
abcenru:   buccaneer
abcenry:   cranberry
abceort:   corroborate
abcertu:   bureaucrat
abcertx:   exacerbate
abceruy:   bureaucracy
abcfhkl:   halfback
abcfilo:   bifocal
abcfklu:   fullback
abcghko:   hogback
abcgikn:   backing
abcgiln:   cabling, balancing
abcgilo:   biological
abcginr:   crabbing, bracing
abcgklo:   backlog
abchiln:   chilblain, bacchanalian, bacchanalia
abchilr:   brachial
abchiot:   cohabit
abchknu:   hunchback
abchkop:   chapbook
abchmry:   chambray
abcijno:   jacobin
abciklm:   blackmail
abciklt:   tailback, backlit
abciklw:   bailiwick
abcikrt:   brickbat
abcilmo:   colombia
abcilmu:   umbilical
abcilmy:   amicably
abcilno:   anabolic
abcilnr:   rabbinical
abcilnu:   incunabula
abcilor:   carbolic
abcilot:   lactobacilli, catabolic
abcilry:   crabbily, bacillary
abcimnr:   cambrian
abcinor:   carbonic
abcinot:   botanic, antibiotic
abcinrt:   britannica, britannic
abciort:   acrobatic
abcioru:   caribou
abciouv:   bivouac
abcjkot:   jackboot
abcklmp:   lampblack
abcklor:   rollback
abcklot:   bootblack
abcklpy:   playback
abcklrt:   trackball
abckmru:   buckram
abckoru:   buckaroo
abckotu:   outback
abclnoy:   balcony
abclnty:   blatancy
abclort:   collaborator
abclouv:   vocabula
abclpuy:   culpably
abclrty:   tractably
abclruy:   curably
abcmnot:   combatant
abcnouy:   buoyancy
abcorty:   corroboratory
abdefit:   beatified
abdeflo:   foldable
abdeflr:   deferrable
abdeflt:   flatbed
abdefor:   forbade
abdeghi:   bigheaded, bighead
abdegin:   beading, badinage
abdegir:   brigadier, brigade, abridger, abridged, abridge
abdeglm:   gambled
abdeglr:   garbled, degradable, belgrade, bedraggled, bedraggle, barelegged
abdegno:   bondage
abdegnr:   beargarden
abdegnt:   abnegated
abdegnu:   unbandaged
abdegry:   graybeard
abdehlr:   halberd
abdehlu:   bullhead
abdehno:   bonehead
abdehnr:   barehanded
abdehor:   headboard, harbored, deborah, abhorred
abdehrt:   threadbare, breathed, breadth
abdehry:   hyderabad
abdeiln:   deniable, belinda
abdeilp:   piebald, bipedal
abdeilt:   editable, debilitated, debilitate
abdeilu:   audible
abdeilv:   dividable
abdeilw:   bewailed
abdeinr:   brandied, brained
abdeirt:   diatribe, arbitrated
abdeirw:   bawdier
abdeitu:   beatitude
abdejru:   abjured
abdekln:   blanked
abdeklu:   baulked
abdekmn:   embanked
abdekmr:   embarked
abdekry:   daybreak
abdelmn:   emendable, damnable
abdelmo:   moldable
abdelmr:   redeemable, rambled, marbled
abdelmt:   embattled
abdelno:   belladonna, ballooned
abdelnp:   dependable
abdelnr:   blander, bandleader
abdelnt:   tableland
abdelnu:   unlabelled, unlabeled
abdelor:   labored, belabored, adorable
abdelot:   bloated, balloted
abdelow:   dowable
abdelpt:   depletable, baldpate, adaptable
abdelrt:   tradable
abdelru:   durable
abdelrw:   warbled, brawled
abdelry:   readably
abdeltu:   tabulated
abdelty:   debatably, belatedly
abdemno:   bemoaned, abdomen
abdemor:   bombarded
abdemru:   bermuda
abdenor:   deadborn, broadened, broaden
abdenou:   abounded
abdenrt:   bertrand, bernadette, bartender, bantered
abdenru:   unbarred
abdenrz:   brazened
abdentu:   unabated, debutante
abdenux:   bandeaux
abdenvw:   waveband
abdeopr:   paperboard
abdeort:   aborted
abdeoru:   bordereau
abdeorv:   overboard
abdeorw:   wardrobe
abdertv:   reverberated
abderty:   betrayed
abdflor:   floorboard
abdfort:   footboard
abdgiln:   dabbling, balding
abdgilr:   garibaldi
abdgino:   abandoning
abdginr:   brigand, branding, braiding, abridging, abrading
abdginu:   daubing
abdginw:   windbag
abdginy:   bandying
abdgluy:   ladybug
abdgnov:   vagabond
abdgnow:   bandwagon
abdgotu:   gadabout
abdhiln:   handbill
abdhirt:   birdbath
abdhkno:   handbook
abdhlot:   bloodbath
abdilnw:   baldwin
abdilor:   billboard
abdilot:   tabloid
abdilry:   ribaldry, rabidly, ladybird
abdilrz:   blizzard
abdiluy:   audibly
abdilwy:   bawdily
abdinor:   inboard
abdinru:   burundian
abdipru:   upbraid
abdirtu:   dubitatur
abdirty:   rabidity
abdituv:   dubitavit
abdjmor:   doorjamb
abdlmny:   damnably
abdlmor:   lombard, broadloom
abdlory:   broadly, adorably
abdlruy:   durably
abdmort:   mortarboard
abdortu:   troubadour, outboard
abdorty:   boatyard
abdorwy:   broadway
abefikr:   firebreak
abefiln:   infallible, ineffable, fineable, finable
abefilr:   friable, flabbier, fireball
abefilx:   fixable
abefity:   beatify
abeflnu:   baneful
abeflot:   floatable
abeflpr:   preferable
abefluy:   balefully
abefort:   barefoot
abefrtu:   butterfat
abefruy:   february
abeghlu:   laughable
abeghmr:   maghreb
abegiln:   labeling, enabling, bengali, belgian
abegilr:   gabrielle, gabriella, gabriel
abegimn:   beaming
abegimt:   megabit
abegino:   begonia
abeginr:   beggaring, bearing, bargainee, barbering
abegint:   benignant, beating, battening, abnegating, abetting
abegipr:   bagpiper
abegirt:   arbitrage
abegirv:   verbiage
abegity:   gigabyte
abegkor:   brokerage
abeglmn:   manageable
abeglmr:   gambrel, gambler
abeglot:   globate
abeglrt:   regrettable
abeglru:   beleaguer, arguable
abeglry:   beggarly, agreeably
abegltv:   vegetable
abegmnr:   bargemen, bargeman
abegmor:   embargo
abegmru:   umbrage
abegmty:   megabyte
abegnrt:   battenberg
abegopy:   pageboy
abegort:   abrogate
abegorx:   gearbox
abehilr:   hirable
abehilt:   habitable
abehimo:   bohemia
abehinr:   bahrein
abehirt:   breathier
abehitu:   habitue, habituate
abehitw:   whitebait
abehkrt:   heartbreaker, heartbreak
abehkru:   hauberk
abehlpt:   alphabet
abehlrt:   breathable, blather
abehnty:   bethany
abehort:   heartthrob, bathrobe
abehqtu:   bequeath
abehrty:   breathy
abeijmn:   benjamin
abeiklr:   balkier
abeiklt:   bakelite
abeiknt:   beatnik
abeikrt:   tiebreaker
abeikwy:   bikeway
abeilmp:   impalpable
abeilmr:   balmier
abeilmt:   timetable, timbale, limitable, illimitable
abeilmx:   mixable
abeilnp:   plebeian, biplane
abeilnr:   liberian, bilinear, ballerina
abeilnt:   libelant, attainable
abeilnu:   unalienable
abeilnv:   enviable
abeilnw:   winnable, wainable
abeilny:   inalienably, biennially
abeilov:   violable
abeilpr:   repairable, irrepealable, irreparable
abeilpt:   pitiable
abeilrt:   liberate, irritable, bilateral, arbitrable
abeilru:   reburial
abeilrv:   variable, relievable
abeilry:   reliably, liberally, biyearly
abeilrz:   realizable, liberalize
abeiltv:   ablative
abeilvy:   believably
abeimnt:   ambient
abeimru:   uberrima
abeimwz:   zimbabwe
abeinor:   airborne
abeinrt:   rabbinate, inebriate
abeinrw:   brawnier
abeiotv:   obviate
abeiprt:   bipartite
abeiptz:   baptize
abeirtu:   barbiturate, attribute
abeirtv:   vibrate, breviate, abbreviate
abeirvy:   breviary
abeitux:   bauxite
abejkrw:   jawbreaker
abejlny:   jellybean
abejmnt:   enjambment
abejmor:   jeroboam, jamboree
abejnow:   jawbone
abeklmr:   remarkable
abeklno:   anklebone
abeklnr:   blanker
abeklnt:   blanket
abeklot:   keelboat
abeklrw:   lawbreaker
abekmnt:   embankment
abekmor:   bookmaker
abeknot:   banknote
abekory:   yearbook
abekrtw:   breakwater
abekrwy:   breakaway
abelmno:   nobleman
abelmnt:   lamentable, lambent, embattlement, battlement
abelmnu:   unnamable, albumen
abelmny:   amenably
abelmor:   memorable
abelmov:   moveable, movable
abelmoz:   bamboozle
abelmpr:   preamble, permeable
abelmru:   umbrella
abelmtu:   mutable, ambulate
abelnop:   beanpole
abelnot:   notable
abelnoy:   baloney
abelnpt:   patentable
abelnpu:   unappealable
abelnrt:   rentable
abelnru:   unbearable, nebular
abelnrv:   venerable
abelnrw:   renewable
abelnry:   blarney
abelntu:   untenantable, untenable, uneatable, unbeatable, tunable
abelnyz:   analyzable
abelopr:   probable, operable
abelopt:   potable
abelort:   tolerable, elaborate
abelotw:   towable
abelovy:   volleyball
abelprt:   repeatable
abelprv:   preverbal
abelpry:   repayable, reparably, ballplayer
abelqru:   albuquerque
abelquy:   equably
abelrtu:   rebuttal, rebuttable
abelrtv:   vertebral
abelrtw:   tableware
abelrty:   betrayal
abelrvy:   verbally, bravely
abeltux:   tableaux
abeltwy:   beltway
abemnot:   boatmen
abemntu:   abutment
abemort:   barometer
abenort:   baronet
abenoty:   bayonet
abenotz:   benzoate
abenqtu:   banquette, banquet
abeoprt:   reprobate, probate
abeopry:   paperboy
abeoqru:   baroque
abeortw:   browbeat
abertuy:   butyrate
aberwyz:   breezeway
abfgiln:   baffling
abfgoru:   faubourg
abfilmu:   bumbailiff
abfilny:   infallibly
abfilty:   fallibility, affability
abfilux:   fabliaux
abfloru:   balfour
abfnotu:   bouffant
abghiln:   highballing
abghint:   inhabiting, bathing
abghluy:   laughably
abghmru:   hamburg
abghopr:   barograph
abgikln:   blanking, balking
abgiknr:   braking, barking
abgilmn:   lambing, gambling, blaming, ambling
abgilno:   ballooning
abgilnr:   garbling, blaring, balbriggan
abgilnt:   tabling, battling, ablating
abgilnu:   bilingual
abgilnw:   bawling
abgilnz:   blazing
abgilot:   obligatio
abgilrt:   gibraltar
abgilru:   bulgaria
abgimno:   mamboing
abginor:   bargainor
abginot:   tobogganing, tabooing, obtaining, boating
abginrt:   arbitrating
abginru:   unbarring
abginrv:   braving
abginry:   braying
abginrz:   brazing
abgintu:   abutting
abgintw:   batwing
abglmou:   lumbago
abglnot:   oblongata, longboat
abgloru:   globular
abglruy:   burglary, arguably
abgnotu:   gunboat
abhilno:   hobnail
abhiltu:   halibut, habitual
abhilty:   habitably, habitability
abhimnp:   amphibian
abhimnr:   brahmin
abhimop:   homophobia
abhinot:   inhabitation, habitation
abhlmot:   mothball
abhmort:   bathroom
abhnotu:   autobahn
abijnpu:   punjabi
abiknru:   burkina
abilmno:   binomial
abilmnu:   albumin
abilmox:   mailbox
abilmpy:   impalpably
abilmty:   amiability
abilnor:   baronial
abilnot:   oblation, libation, battalion, abolition, ablation
abilnov:   bolivian
abilnoy:   babylonian
abilnrt:   brilliant
abilnru:   binaural
abilnrz:   brazilian
abilnty:   inability, banality, attainability
abilnuy:   biannually
abilopr:   parboil
abilort:   orbital
abilory:   boilary
abilpty:   pliability, pitiably, palpability, palatability
abilrty:   tribally, ratability, irritably, irritability, arbitrarily
abilrvy:   variably
abiltvy:   viability, livability, availability
abiltxy:   taxability
abimnot:   manitoba, ambition, abomination
abimopr:   paramaribo
abinort:   arbitration, abortion
abinorw:   rainbow
abinotv:   obviation
abinrtv:   vibrant
abinrty:   brittany
abiortv:   vibrator, vibrato
abirtuy:   tributary
abklnor:   bankroll
abklruw:   bulwark
ablmnor:   abnormal
ablmnru:   laburnum
ablmntu:   ambulant
ablmopw:   blowlamp
ablmovy:   movably
ablmtuy:   mutably
ablnoty:   notably
ablopry:   probably
ablortu:   tabulator
ablorty:   laboratory
ablrtuy:   brutally
abmnoru:   baronum
abmortu:   tambour, marabout
abnortu:   turnabout, runabout
abnotuy:   buoyant
aboprty:   probatory
acdefil:   decalcified, calcified
acdefin:   financed, fancied, defiance, affianced
acdefip:   pacified
acdefir:   acidifier
acdeflt:   defalcated, defalcate
acdefmn:   mcfadden
acdefpr:   prefaced
acdefrt:   refracted, crafted
acdeftu:   effectuated
acdeghn:   changed
acdeghr:   recharged, charged
acdegil:   algaecide
acdegin:   acceding
acdegko:   dockage
acdegkp:   packaged
acdegln:   glanced, clanged
acdegmr:   decagram
acdegno:   dodecagon, decagon, congaed
acdegnu:   uncaged
acdegor:   cordage
acdehik:   chickadee
acdehin:   hacienda, enchained, echidna, chained
acdehip:   headpiece
acdehir:   chaired
acdehiv:   achieved
acdehkl:   chalked
acdehkw:   whacked
acdehln:   channeled, chandelled, chandelle
acdehlo:   coolheaded
acdehlr:   clearheaded, cheerleader, chalder
acdehlt:   latched, decathlete
acdehmp:   champed
acdehmr:   marched, drachmae, charmed
acdehmt:   matched
acdehnp:   cheapened
acdehnr:   ranched, chancered, adherence
acdehnt:   enchanted, chanted
acdehop:   poached
acdehor:   dodecahedra
acdehot:   cathode
acdehpr:   preached, parched
acdehpt:   patched
acdehrt:   reattached, chattered, chartered, charted, cathedra
acdehtw:   watched
acdehty:   yachted
acdeilm:   medical, declaimed, declaim, decimal, claimed, acclaimed
acdeiln:   icelandic, iceland, decennial, dalliance, celandine
acdeilt:   latticed, dialectical, dialectic, dialectal, dialect, delicate, citadel, ciliated
acdeilv:   caviled
acdeily:   delicacy
acdeimn:   academician
acdeimr:   medicare, camaraderie
acdeimt:   medicated, medicate, emaciated, decimated, decimate
acdeimy:   immediacy
acdeimz:   macadamized, macadamize
acdeinr:   riddance, radiance
acdeint:   indicated, indicate, candidate, actinide, accident
acdeinu:   induciae, audience
acdeinv:   deviance
acdeiny:   cyanided, cyanide
acdeipr:   pericardia, parricide
acdeipt:   decapitated, decapitate
acdeirt:   rededicated, rededicate, eradicated, eradicate, accredited, accredit
acdeitv:   deactivated, deactivate, addictive, activated
acdejkt:   jacketed
acdejlo:   cajoled
acdejnt:   adjacent
acdejny:   adjacency
acdekln:   clanked
acdeklo:   deadlocked, deadlock, cloaked
acdeklr:   crackled
acdeklt:   tackled
acdeklu:   caulked
acdeklw:   cakewalked
acdeknr:   cranked
acdekor:   croaked
acdekqu:   quacked
acdekrt:   tracked, racketeered, racketed
acdekrw:   wracked
acdelmn:   manacled
acdelmp:   clamped
acdelno:   concealed, colonnaded, colonnade, canoodled, canoodle
acdelnr:   calendar
acdelnu:   unlaced, uncalled
acdelnv:   cleveland
acdelor:   corralled, collared, caroled, caracoled
acdelot:   located, collocated, collated, allocated
acdelpr:   replaced, parceled
acdelpt:   placated
acdelrt:   lacerated, decretal, decelerated, decelerate, clattered, altercated, accelerated
acdelrw:   crawled
acdeltu:   calculated
acdemno:   commendam, commanded
acdemnp:   encamped
acdemor:   comrade, caromed, camcorder
acdemot:   accommodated, accommodate
acdempr:   cramped
acdemrt:   macerated, demarcated, demarcate, decameter, cremated
acdemuv:   vacuumed
acdenor:   ordnance, concordance, accordance
acdenot:   contacted, concatenated, anecdote
acdenou:   unannounced, announced
acdenpr:   pranced
acdenpt:   catnapped
acdenpu:   uncapped
acdenrt:   recanted, entranced, decanter, cantred, cantered
acdenru:   endurance, durance
acdenry:   decennary, ardency
acdenrz:   credenza
acdentu:   uneducated, unaccented, accentuated
acdeort:   redecorated, redecorate, redcoat, redactor, doctorate, detractor, decorator, decorated, decorate
acdeoru:   ecuador
acdeotv:   advocated, advocate
acdeprt:   deprecated, deprecate, carpeted
acdeqtu:   aqueduct
acdequy:   adequacy
acdertu:   traducer, traduced, traduce, decatur
acdertx:   extracted, execrated
acdetuv:   evacuated
acdetvx:   excavated
acdfhnu:   handcuff
acdfilu:   fiducial
acdfily:   flaccidly
acdfino:   aficionado
acdfirt:   diffract
acdgiln:   cladding, candling
acdgino:   cannonading
acdginr:   carding, cardigan
acdgint:   indicating, dictating, addicting
acdginu:   adducing
acdginv:   advancing
acdginy:   cyaniding, caddying
acdgort:   dogcart
acdhino:   indochina
acdhinp:   handicap
acdhinr:   arachnid
acdhkno:   dockhand
acdhkrt:   hardtack
acdhlnp:   handclap
acdhlnt:   catchland
acdhnow:   cowhand
acdhnrt:   handcart
acdhruy:   duarchy, churchyard
acdijlu:   judicial
acdijtu:   judicata
acdilmu:   caladium
acdilnr:   cardinal
acdilny:   candidly
acdilor:   cordial
acdiloz:   zodiacal
acdilpr:   parricidal
acdilpy:   placidly
acdilrt:   diacritical
acdilrw:   wildcard
acdilry:   radically, acridly
acdiltw:   wildcat
acdilty:   didactically, dactylic
acdimno:   nomadic, monadic, dominican, dominica
acdimny:   dynamic, cyanamid
acdimot:   idiomatic, diatomic
acdimrt:   dramatic
acdinor:   draconian, concordia, accordion
acdinot:   indication, dictation, diatonic, condonation, addiction
acdiopr:   picador
acdiort:   dictator, carotid
acdiotu:   autodidact
acdipry:   picardy
acdiqru:   quadric
acdirty:   caryatid, acridity
acdituv:   viaduct
acdituy:   audacity
acdjntu:   adjunct
acdjqru:   jacquard
acdklnu:   auckland
acdklop:   padlock
acdkory:   dockyard
acdlnor:   caldron
acdlnot:   cotland
acdlort:   doctoral
acdmnot:   commandant
acdmoru:   docudrama
acdnort:   concordat, concordant, accordant
acdnorv:   cordovan
acdortu:   adductor
acdortv:   advocator
acefgin:   effacing
acefgnr:   fragrance
acefhmr:   chamfer
acefhru:   chauffeur
acefikr:   firecracker
acefilm:   maleficia, malefic
acefilr:   filacer
acefilt:   felicitate, facilitate, facelift
acefily:   facilely
acefinr:   refinance, financier, fancier
acefiny:   inefficacy
acefiot:   officiate
acefipr:   pacifier
acefirt:   craftier, certificate, cafeteria, artificer, artifice
acefitv:   affective
aceflmt:   metcalf
aceflnr:   freelancer, freelance
aceflnu:   affluence
aceflpu:   peaceful
aceflru:   careful
acefltu:   fluctuate, effectual
acefmnt:   effacement
acefnru:   furnace
acefort:   refractor, effractor
acefotu:   outface
acefprt:   perfecta
acefpty:   typeface
acefrtu:   fracture
aceghin:   enhancing, enchaining
aceghln:   challenge
aceghnr:   changer
aceghnx:   exchange
aceghou:   gouache
acegiln:   inelegance, enlacing, cleaning, canceling, angelical, angelica, angelic, allegiance
acegilo:   geological, ecological, collegial, collegia
acegilp:   pelagic
acegilr:   glacier, allergic
acegily:   gigacycle
acegimn:   menacing
acegimr:   grimace
acegino:   coinage, canoeing
aceginr:   grecian, carnegie, careering, careening
acegint:   enacting, antigenic, accenting
acegiot:   geotactic, cogitate
acegirt:   geriatric, cigarette
acegirv:   vicarage
acegklr:   grackle
acegkmo:   gamecock
acegkor:   corkage
acegkpr:   repackage, packager
acegkrw:   wreckage
aceglmy:   megacycle
aceglno:   congeal, collagen
aceglou:   colleague, cagoule
acegnor:   cornage, arrogance
acegnot:   cotangent, cognate
acegnty:   tangency
acegopr:   cooperage
acegort:   greatcoat
acegoru:   courage
acegorv:   coverage
acegrtu:   curettage
acehilm:   michael, chemical
acehiln:   chilean
acehilp:   cephalic
acehilr:   hierarchical, charlie
acehilt:   ethical, athletic
acehimn:   mechanic, machine
acehimp:   impeach
acehimr:   chimera
acehimt:   thematic
acehinr:   chancier
acehint:   technician
acehipr:   peachier
acehipt:   pathetic, hepatica, hepatic, apathetic
acehirt:   hieratic, chattier, catchier, architect
acehirv:   archive, achiever
acehiry:   hierarchy
acehirz:   zechariah, archaize
acehitz:   catechize
acehkmr:   marrakech
acehkmt:   checkmate
acehkny:   hackney
acehlmy:   alchemy
acehlno:   nonchalance
acehlnr:   charnel
acehlnv:   avalanche
acehlop:   epochal
acehlor:   chorale, cholera
acehlot:   chocolate
acehlpt:   chaplet
acehlpy:   cheaply
acehlrt:   tracheal
acehlry:   charley
acehmno:   coachmen
acehmnr:   menarche
acehmnt:   enhancement, enchantment, catchment, attachment
acehmot:   chamotte
acehmrt:   rematch
acehnor:   ranchero, encroach
acehnpr:   perchance
acehnpt:   penchant
acehnrt:   trenchant, tranche, enchanter, charente, chanter
acehnry:   chancery
acehnty:   chantey
acehopr:   reproach, poacher
acehort:   theocrat
acehorv:   overreach, overarch
acehprt:   chapter
acehpry:   preachy
acehpux:   chapeaux
acehrtw:   watcher
acehrty:   yachter, treachery, hatchery
acehtux:   chateaux
aceiklt:   catlike
aceikmn:   nickname
aceikmo:   cockamamie
aceiknr:   crankier
aceikrt:   tackier
aceikrw:   wackier
aceilmn:   calcimine, calamine
aceilmp:   piecemeal
aceilmr:   reclaim, miracle, millrace, clammier
aceilmt:   metallic, climate, acclimate
aceilmx:   exclaim
aceilmy:   mycelia
aceilno:   cannelloni
aceilnp:   pinnacle, pelican, panicle, appliance
aceilnr:   reliance, carnelian
aceilnt:   licentiate, clientela, centennial, canticle, anticline
aceilnv:   valencia
aceilny:   encyclical
aceilnz:   canalize
aceilop:   calliope
aceilor:   calorie
aceiloz:   localize
aceilpr:   replica, caliper
aceilpt:   tailpiece, plicate, elliptical, cataleptic
aceilpy:   epicyclical
aceilrt:   retractile, recital, electrical, article
aceilru:   auricle
aceilrv:   clavier, cervical, caviler, cavalier
aceilry:   clerically
aceiltu:   aciculate
aceiltv:   vacillate, levitical
aceilty:   eclectically
aceiltz:   italicize
aceilxy:   lexically
aceimnp:   pemmican
aceimnr:   mercian, crimean, carmine, americana, american
aceimnt:   mincemeat, maintenance, cinematic
aceimnx:   mexican
aceimpr:   paramecia
aceimpt:   peacetime
aceimrt:   mercati
aceimru:   americium
aceimtv:   civitatem
aceinot:   taconite, concatenation, aconite
aceinov:   connivance
aceinoz:   canonize
aceinpt:   pittance, patience, incapacitate, capacitance, anticipate
aceinpu:   pecunia
aceinrt:   reincarnate, nectarine, intricate, interact, incinerate, incertae, incerta, incarnate, incarcerate, certain, centenarian
aceinru:   uncannier
aceinrv:   variance, invariance
aceinry:   cinerary
aceintu:   enunciate
aceintv:   vacentia, vaccinate, inactive, inactivate
aceintx:   inexact, excitant
aceinty:   tenacity
aceiopt:   petticoat
aceiort:   erotica, certiorari
aceiotv:   vocative, evocative
aceiprt:   precipitate, practice, peripatetic, participate, paretic, crepitate, appreciate
aceiptv:   captive, captivate
aceiqru:   reacquire, acquire
aceirtu:   caricature
aceirtv:   retractive, recreative, recitative, reactive, reactivate, creative, attractive
aceirtx:   extricate
acejltu:   ejaculate
aceklmr:   mackerel
aceklnr:   cracknel
aceklpt:   placket
aceklrt:   tackler
acekmpr:   peacemaker, pacemaker
aceknrw:   neckwear
acekntu:   nantucket
acekorw:   cookware
acekrty:   rackety
acelmno:   coleman
acelmnr:   rancelmen, rancelman
acelmnt:   cattlemen, cattleman
acelmny:   cyclamen
acelmot:   camelot
acelmrt:   telecamera
acelmtu:   maculate, cumulate, calumet, accumulate
acelmty:   cyclamate
acelnop:   paleocene
acelnor:   corneal, concealer
acelnot:   lancelot
acelnov:   covalence, conclave
acelnow:   allowance
acelnpr:   parlance
acelnpt:   placental, placentae, placenta, pentacle
acelnpu:   cleanup
acelnpy:   anyplace
acelnrt:   central
acelnru:   unclear, nuclear, cerulean
acelnrv:   relevance, canaveral
acelnrw:   lawrence
acelnry:   larceny
acelntu:   nucleate, accentual
acelnty:   latency, acetylene
acelopr:   corporeal
acelopt:   polecat
acelopu:   populace
aceloqu:   coequal
acelort:   relocate, reallocate, electorate, electoral, correlate, colorectal, collateral, accelerator
acelorv:   overcall, coverall
aceloty:   acolyte
acelouv:   vacuole
acelprt:   receptacle, plectra
acelpry:   prelacy
acelptu:   peculate
acelqru:   lacquer
acelrtu:   ulcerate, recalculate, acculturate
acelrwy:   clearway
aceltuy:   acutely
aceltxy:   exactly
aceltyz:   catalyze
acemnop:   copeman
acemnor:   romancer, romance, necromancer, cameroon, cameron
acemnot:   commentate, cantonment
acemnpr:   permanence
acemnpt:   encampment
acemnrt:   mercantant, amercement
acemnrw:   crewman
acemnry:   mercenary
acemopr:   compare
acemort:   macerator, commemorator, commemorate
acemorv:   overcame
acenort:   enactor, concentrator, concentrate, carotene
acenoru:   announcer
acenorw:   careworn
acenotu:   countenance
acenotv:   covenantee, covenant, centavo
acenovy:   conveyance
acenprt:   repentance, carpenter
acenpry:   pernancy, parcenary
acenptu:   punctuate, nuncupate
acenptx:   expectant
acenrtu:   utterance, truncate, centaur
acenrty:   tercentenary, centenary
aceoprt:   protectorate, procreator, procreate, corporate, acceptor
aceoprx:   praecox
aceoptu:   outpace
aceortu:   eurocrat, accouter
aceortv:   overreact, overcoat, overact
aceortx:   extractor, execrator
aceorvy:   carryover
aceprtu:   recuperate, recapture, capture
aceqrtu:   racquet
acertuv:   curvature
acfghin:   chafing, chaffing
acfginy:   fancying
acfilnt:   fanatical
acfilnu:   fanciful
acfilny:   financially, fancily
acfilor:   calorific
acfiloy:   officially
acfilpy:   pacifically
acfilrt:   artificial
acfilry:   farcically, clarify
acfilty:   facility
acfimor:   formica
acfinot:   notification, faction
acfinou:   confucian
acfinrt:   infarct, frantic
acfiort:   officiator, fractio
acfjklp:   flapjack
acflmno:   mooncalf
acfltuy:   tactfully, faculty, factually
acfmnru:   francum
acfmotu:   factotum
acforty:   factory
acghikn:   hacking
acghimn:   michigan, machining
acghino:   coaching
acghinp:   chapping
acghinr:   ranching, charring, charging, chairing, chagrin, arching
acghint:   thatching, hatching, chatting, chanting, catching, attaching
acghinu:   unchanging, unchaining
acghipr:   graphic
acghnot:   chattanooga
acghnry:   gynarchy
acghntu:   uncaught
acgijkn:   jacking
acgikln:   lacking, clanking, clacking, cackling
acgikmn:   nicknaming
acgikmr:   gimcrack
acgiknp:   panicking, packing, packaging
acgiknr:   racking, cranking, cracking
acgiknt:   tacking, attacking
acgilmn:   manacling, clamming, claiming, calming, calcimining, acclaiming
acgilmy:   magically
acgilno:   logician
acgilnp:   placing, clapping
acgilnt:   lactating, catcalling
acgilnu:   unlacing
acgilnv:   galvanic, caviling, calving
acgilnw:   clawing
acgilnz:   canalizing, anglicizing
acgilor:   cigarillo
acgiloy:   logically, illogically, glaciology
acgiloz:   zoological
acgilrt:   tragical
acgimno:   cognomina
acgimnp:   camping, campaigning, campaign
acgimnr:   grimacing, cramming
acgimor:   microgram
acginor:   organic, inorganic
acginot:   containing, contagion, contacting, cogitation, cogitating, coating
acginou:   announcing
acginox:   coaxing
acginoz:   canonizing
acginpr:   prancing, crapping, carping
acginpt:   incapacitating, catnapping, captaining, anticipating
acginpu:   uncapping
acginrt:   tracing, incarnating, crating, carting, attracting
acginru:   uncaring, nicaraguan, nicaragua, accruing
acginrv:   craving, carving
acginry:   carrying
acginrz:   crazing
acgintu:   actuating
acgintv:   vaccinating, vacating, inactivating, activating
acglmou:   glaucoma
acglnor:   clangor
acglnot:   octagonal
acgnrvy:   vagrancy
achijnt:   jacinth
achilmt:   thalamic
achilnp:   chaplin, chaplain, appalachian
achilnr:   anarchical
achilot:   catholic
achilpt:   aliphatic
achilrv:   chivalric, archival
achilry:   charily
achilty:   chattily
achimno:   mohican
achimnr:   chairman
achimrt:   matriarch
achinpu:   capuchin
achinrt:   trichina
achinty:   hyacinth, cynthia
achiort:   thoracic, haricot, chariot
achiprt:   patriarch
achirtu:   haircut, autarchic
achirty:   charity
achkorw:   hackwork, coachwork
achlmry:   lachrymal
achlnot:   nonchalant
achlnoy:   halcyon
achlnrt:   charlatan
achlntu:   unlatch
achlopt:   potlatch, catchpoll
achmnor:   monarch, anchorman
achmnoy:   monomachy
achmnru:   churchman
achmntw:   watchman
achmopr:   camphor
achmort:   trachoma, chartroom
achmotu:   outmatch
achmpry:   pharmacy
achnopy:   cacophony
achnovy:   anchovy
achnpuy:   paunchy
achnruy:   raunchy
achopry:   apocrypha
achortu:   cutthroat, coauthor
achptuz:   chutzpah
achrtuy:   autarchy
acijlmo:   majolica
acijnop:   japonica
acijnot:   jactitation
aciklor:   airlock
aciklot:   cocktail
acikmnw:   mackinaw
aciknor:   koranic
aciknot:   antiknock
aciknpy:   panicky
acikprt:   patrick
acikrtu:   autarkic
acilmno:   monomaniacal
acilmnr:   criminal
acilmnt:   claimant, anticlimactic
acilmny:   maniacally, inimically
acilmop:   accompli
acilmot:   committal
acilmoy:   comically
acilmty:   climactically, calamity
acilnor:   ironical, clarion, carolinian, carolina, carillon
acilnot:   location, lactation, inclination, cottontail, conciliation, collocation, collation, coalition, catalonian, catalonia, allocation
acilnov:   volcanic, convivial
acilnoy:   laconically, canonically
acilnpr:   principal
acilnpt:   applicant
acilnpy:   pliancy
acilnru:   ranunculi
acilnrv:   carnival
acilnry:   ancillary
acilntu:   nautical, lunatic
acilnty:   analyticity, analytically, analytical, analytic
acilnuy:   uncannily
acilnvy:   valiancy
acilopr:   coprolalia
acilopt:   topical, political, optical, occipital, capitol, apolitical
aciloqu:   colloquial, colloquia
acilort:   oratorical, cortical, clitoral
acilotv:   voltaic
acilotx:   toxical
aciloty:   locality
acilprt:   practical, piratical, participial, clipart
acilpry:   capillary
acilptu:   capitula
acilpty:   typically, typicality, typical, atypically, atypical
acilqtu:   acquittal
acilquz:   quizzical
acilrtu:   curtail, actuarial
acilrty:   critically, criticality, clarity, alacrity
acilruy:   crucially, circularly
acilryz:   crazily
aciltuv:   victual
aciltuy:   actuality
aciltvy:   acclivity
acimnop:   companion
acimnor:   minorcan, minorca, macaroni, carcinoma
acimnot:   monatomic, contamination, contaminant, concomitant, anatomic, amniotic
acimnou:   canonicum
acimnru:   cranium
acimntu:   actinium
acimnty:   intimacy
acimort:   aromatic
acimotu:   automatic
acimotx:   axiomatic
acimpry:   primacy
acimrtu:   traumatic
acimtuv:   viaticum
acinopr:   paranoiac, capricorn
acinopt:   optician, incapacitation, caption, captation, capitation, anticipation
acinopu:   cappuccino
acinoqu:   coquina
acinort:   traction, ratiocinator, ratiocination, raincoat, narcotic, incarnation, croatian, coronation, contrario, contraction, carnation, attraction
acinotu:   continuation, continua, caution, auction, annunciation, actuation
acinotv:   vocation, vaccination, vacation, invocation, inactivation, convocation, avocation, activation
acinotx:   toxicant, intoxication, intoxicant
acinoty:   cyanotic
acinotz:   canonization
acinprt:   patrician, participant
acinpty:   incapacity, captaincy
acinqtu:   acquaint
acinrtu:   taciturn, curtain
acinrty:   intricacy, intracity
acinruy:   inaccuracy
acintvy:   inactivity
acioprt:   patriotic, participator, capacitor, apricot
acioptu:   autoptic
aciopty:   opacity
acioptz:   pizzicato
aciortu:   autocratic
aciortv:   victoria, activator
aciorty:   atrocity
aciprty:   rapacity
aciprvy:   privacy
aciptuy:   paucity
aciptvy:   captivity
acirtux:   curatrix
acituvy:   vacuity
acjklow:   lockjaw
acjkopt:   jackpot
acjloru:   jocular
acjmnor:   majorcan
acklmor:   cloakroom
acklorw:   warlock
ackmopr:   pockmark
acknory:   conakry
ackoprt:   crackpot
aclmnou:   communal
aclmnpu:   campanula
aclmnuy:   calumny
aclmory:   cyclorama
aclnopr:   coplanar
aclnort:   contralto, colorant
aclnoty:   clayton
aclnptu:   punctual
aclnruv:   avuncular
aclntvy:   vacantly
aclopru:   copular
aclortu:   coloratura, calculator, allocatur
aclrtuy:   culturally, cartulary
acmnopr:   crampon
acmnopy:   company, accompany
acmnort:   monocrat, cormorant, commorant
acmnory:   monocracy, acronym
acmnotu:   catamount
acmnpry:   rampancy
acmoprt:   compactor
acnoptu:   occupant
acnopuy:   occupancy
acnortu:   turncoat, courant
acnorty:   contrary
acnotuy:   accountancy
acnrtuy:   truancy
acoprtu:   procurator
acopruy:   procuracy
acortuy:   autocracy
adefgin:   deafening
adefgln:   flanged, fangled
adefglo:   foldage
adefglt:   flagellated
adefgor:   foraged
adefgrt:   grafted
adefguw:   guffawed
adefhlt:   flathead
adefhno:   offhanded
adefhnr:   freehand
adefhor:   forehead
adefhrt:   feathered, fathered
adefhrw:   wharfed
adefilr:   airfield
adefilt:   filiated, affiliated
adefimn:   damnified
adefimr:   reaffirmed, ramified, affirmed
adefinr:   refrained, infrared
adefint:   fainted, defiant
adefirt:   ratified
adefitx:   fixated
adefkln:   flanked
adefknr:   franked
adeflmn:   enflamed
adeflnt:   flattened
adeflor:   freeloader, freeloaded, freeload
adeflot:   floated
adeflrt:   flattered, faltered
adeflru:   dreadful
adeflry:   federally, defrayal
adeflrz:   frazzled
adefltu:   faulted, defaulted, default
adefluy:   feudally
adefmnr:   freedman
adefmor:   forearmed
adefntu:   undefeated
adefnuz:   unfazed
adeforv:   favored
adeforw:   forwarder, forwarded
adefory:   forayed, feodary
adefotu:   fadeout
adefrtu:   featured
adefrtw:   afterward
adefruy:   feudary
adeghin:   highhanded, heading, deadheading
adeghip:   pigheaded
adeghln:   danelagh
adeghlu:   laughed
adeghpr:   paragraphed, graphed
adeghrt:   gathered
adegikn:   kneading
adegiln:   leading, gladdening, dealing, aligned
adegilp:   pillaged
adegilt:   litigated
adegilz:   legalized
adegimn:   maddening, imagined, demeaning, demanding, amending, adeeming
adegimr:   diagrammed
adegimt:   mitigated
adeginp:   appending
adeginr:   rereading, regarding, regained, reading, ingrained, grenadine, grenadier, grained, gardening, gardenia, gardein, endearing, endangering, dreading, deranging, deraign, degrading, arraigned
adegint:   ideating, detaining, attending, antedating
adeginv:   evading
adegirt:   irrigated
adegiru:   gaudier
adegirv:   aggrieved
adegitv:   divagated, divagate
adegjln:   jangled
adegjly:   jaggedly
adeglmn:   mangled
adeglmt:   amalgamated
adeglnr:   greenland, gnarled, garlanded, enlarged, englander
adeglnt:   tangled, entangled, danegelt
adeglnw:   wangled
adeglop:   galloped
adeglot:   gloated
adeglpr:   grappled
adeglpu:   plagued
adeglrt:   relegated
adeglrv:   leveraged, graveled, everglade
adeglry:   raggedly
adegmno:   goddamned
adegmnr:   gendarme
adegmnu:   unmanaged, undamaged, agendum
adegmou:   demagogue
adegmoy:   demagogy
adegmpr:   rampaged
adegmru:   rummaged, demurrage
adegnor:   orangeade, groaned, dragooned, androgen
adegnot:   tangoed
adegnpr:   prearranged
adegnpu:   unpaged
adegnrt:   regranted, regenerated, regardant, granted, generated, dragnet, degenerated, degenerate
adegnru:   unguarded, ungraded, undergrade, grandeur, dungaree
adegnrv:   engraved
adegntv:   advantaged, advantage
adegntw:   twanged
adegopu:   pedagogue
adegopy:   pedagogy
adegort:   retrograded, retrograde, garroted, derogated, derogate, arrogated
adegorw:   dowager
adegory:   goodyear
adegovy:   voyaged
adegpru:   upgraded, upgrade
adegrtu:   graduated, graduate
adegrtv:   aggravated
adegrtx:   exaggerated
adegrty:   tragedy, gyrated, gadgetry
adegrvy:   graveyard
adehiln:   inhaled, headlined, headline
adehilp:   philadelphia
adehilr:   railhead, dihedral
adehily:   headily
adehimn:   maidenhead, handmaiden
adehinp:   pinhead
adehinr:   handier
adehinw:   headwind
adehirw:   rawhide, hardwired
adehiwy:   hideaway
adehklu:   keelhauled
adehknr:   hearkened, hankered
adehknt:   thanked
adehlmn:   manhandled, manhandle
adehlmp:   headlamp
adehlmu:   muddleheaded
adehlnp:   panhandled, panhandle
adehlnr:   handler
adehlnu:   unhealed
adehlot:   loathed
adehlow:   hallowed
adehlrt:   tetrahedral, letterhead, leathered, lathered, haltered
adehlrx:   hexahedral
adehlry:   heraldry
adehlty:   heatedly, deathly
adehmno:   mohammedan
adehmny:   handymen
adehmor:   headroom
adehmoy:   dahomey
adehmpr:   hampered
adehmru:   drumhead
adehnop:   headphone
adehnot:   headnote
adehnpr:   apprehended, apprehend
adehnrt:   threatened, heartened, adherent
adehnru:   unheard, underhanded, underhand, dunderhead
adehnrv:   verandah
adehntu:   unheated, headhunted, headhunt, haunted
adehopx:   hexapod
adehort:   throated, dorothea
adehorv:   overheard, overhead
adehorw:   headword, harrowed, arrowhead
adehory:   hoorayed
adehprt:   preheated
adehrtw:   wreathed, weathered, thwarted, headwater, earthward, deathward
adehrty:   hydrated, hydrate, dehydrated, dehydrate
adeijmr:   jeremiad
adeijno:   adjoined
adeijnr:   jardiniere
adeikly:   ladylike
adeiklz:   alkalized
adeiknp:   kidnapped
adeilmn:   middleman, mainlined
adeilmp:   impleaded, impaled
adeilmr:   remedial, daimler
adeilmt:   militated
adeilmv:   medieval, mediaeval
adeilmy:   medially
adeilno:   dandelion, adenoidal
adeilnr:   ireland, adrenaline
adeilnt:   tideland, initialed, entailed, dilettanti, dilettante, delineated, delineate, datelined, dateline, alienated
adeilnu:   aliunde
adeilnv:   invalided
adeilnx:   dixieland
adeilny:   inlayed
adeilop:   oedipal
adeilor:   railroader, railroaded
adeilot:   etiolated
adeilpr:   reapplied, predial, praedial, pillared, parallelepiped
adeilpt:   plaited, palpitated, palliated, dilapidated, dilapidate, depilated, depilate
adeilqu:   quailed
adeilrt:   trailed, retaliated, retailed, alliterated
adeilrv:   rivaled
adeilry:   readily, drearily
adeilrz:   realized
adeiltu:   latitude, altitude
adeiltv:   validated, validate, levitated, alleviated
adeiluv:   vaudeville
adeilyz:   dialyzed, dialyze
adeimnr:   remained, remainder, meridian, marinade, dramamine, amerindian
adeimnt:   maintained, intimidated, intimidate, intimated, detainment, dementia, animated, adamantine
adeimnx:   examined
adeimor:   airdrome
adeimot:   diatomite
adeimpr:   impaired
adeimpz:   diazepam
adeimrt:   readmitted, readmit, diameter
adeimry:   midyear
adeimtv:   meditative
adeimty:   daytime
adeimxz:   maximized
adeinor:   ordainer, ordained, idoneare, aneroid
adeinot:   iodinate, indentation, ideation, detonation, denotation, antidote, anointed
adeinov:   devonian
adeinoz:   anodized, anodize
adeinpt:   painted
adeinpx:   appendix
adeinrt:   trained, retrained, retained, nitrated, entrained, entertained, detrained, detrain, detainer, denariate, daintier, attainder
adeinrv:   invader
adeinrw:   edwardian, dinnerware
adeintu:   untainted, uninitiated, unaudited, unattained, inundated, inundate
adeintv:   deviant
adeiopr:   parodied
adeiort:   deteriorated, deteriorate
adeiprt:   repatriated, pirated, partied
adeiptu:   aptitude
adeiptv:   adaptive
adeiptx:   expiated, expatiated
adeiqru:   quarried
adeirtv:   derivative
adeirtw:   tidewater, tawdrier
adeirtx:   extradited, extradite
adeirty:   dietary
adeituv:   viduitate
adeitvw:   viewdata
adejmor:   majored
adejntu:   jaunted
adeklnp:   planked
adeklnr:   rankled
adeklny:   nakedly
adeklop:   polkaed
adekmnr:   mandrake, denmark
adekmrt:   trademark, marketed
adeknpw:   knapweed
adeknrw:   reawakened
adekotw:   teakwood
adelmno:   lemonade
adelmnr:   mandrel, dreamland, aldermen, alderman
adelmnt:   mantled, lamented
adelmor:   melodrama, earldom
adelmpt:   maladapted
adelmrt:   trammeled, maltreated
adelmru:   medullar
adelmrv:   marveled
adelmtu:   umlauted, emulated
adelnop:   planeload
adelnor:   oleander, leonardo, leonard
adelnou:   unloaded, duodenal
adelnow:   downloaded
adelnpr:   laplander
adelnpt:   planted
adelnpu:   unplanned
adelnqu:   unequaled
adelnrt:   antlered, alternated
adelnru:   unlearned, unlaundered, laundered, launder
adelnrv:   lavender, landreeve
adelnrx:   alexandra, alexander
adelnry:   learnedly, aldernay
adelnrz:   zealander
adelntu:   untalented, undulated, undulate
adelntw:   wetland
adelnuv:   unvalued, unleavened
adelnyz:   analyzed
adelopr:   paroled, leopard
adelopt:   tadpole
adelopu:   uploaded
adelopw:   walloped
adelort:   tolerated, realloted, leotard, delator
adeloru:   roulade, eurodollar
adelorv:   overloaded, overload
adelprt:   prattled, paltered
adelprv:   palavered
adelprw:   wallpapered
adelpry:   replayed, preparedly, parleyed, parlayed, dapperly
adelpty:   adeptly
adelqru:   quarreled
adelrtu:   adulterer, adulterated, adulterate
adelrtv:   traveled
adelrtw:   trawled
adelrtx:   dextral
adelruv:   revalued
adeltuv:   vaulted, valuated, evaluated, devaluated, devaluate
adeltwz:   waltzed
ademnor:   memoranda, marooned, enamored, demeanor, andromeda
ademnot:   nematode
ademnow:   madwomen
ademnpu:   unmapped
ademnrt:   endearment
ademnru:   unmarred, unmannered, undreamed, undermanned, underarm, unarmed, maundered, maunder
ademnry:   yardmen
ademntu:   untamed, unmated
ademort:   rotterdam, mortared, moderator, moderato, moderated, moderate
ademorv:   overarmed
ademory:   dromedary
ademotu:   automated
ademprt:   tramped, tampered, permeated
ademprv:   revamped
ademptu:   amputated
ademrtu:   matured, maturated
ademrty:   martyred
adenopr:   pardoner, pardoned, operand
adenopt:   notepad
adenort:   detonator, deodorant, attorned
adenoru:   unadorned
adenorv:   endeavored, endeavor, andover
adenorw:   narrowed
adenprt:   trepanned, penetrated, patterned, partnered, parented, entrapped
adenpru:   unprepared, undraped
adenprw:   enwrapped
adenprx:   expander
adenptu:   untapped, unpatented
adenpuv:   unpaved
adenrtu:   untreated, undertenant, underrated, underrate, redundant, natured, durante, denatured, denature, denaturant
adenrtv:   verdant, venerated, enervated
adenrtw:   warranted
adenruw:   underwear, underdrawn, unawarded
adenruy:   unready
adentuv:   vaunted, eventuated
adentuw:   unwanted
adentux:   untaxed, unextenuated, extenuated
adeoprt:   teardrop, readopted, readopt, prorated, predator, perorated, parroted, operated, adopter
adeoprv:   approved
adeortv:   overtraded, overtrade, overrated
adeorvw:   overdraw, overawed
adepqru:   quadruped
adeprtu:   perpetuated, depurated, depurate, departure
adeqrtu:   quartered, quadrate
adeqruv:   quavered
adfginy:   dandifying
adfhlnu:   handful
adfhort:   hartford
adfilnw:   windfall
adfilor:   florida
adfimny:   damnify
adfinru:   unafraid, furandi
adflmnr:   farmland
adflnow:   downfall
adfloru:   foulard
adflorw:   waldorf
adflowy:   foldaway
adghiln:   highland, handling
adghilo:   hidalgo
adghilu:   guildhall
adghinu:   unhanding
adghior:   highroad
adghipr:   digraph
adghitw:   tightwad
adghlno:   longhand
adghlry:   haggardly
adghrtu:   draught
adgijno:   adjoining
adgijnu:   adjudging
adgiknp:   kidnapping
adgilmr:   madrigal, grimaldi
adgilno:   loading, diagonal
adgilnp:   paddling, dappling
adgilnr:   larding, garlanding, draggling, darling
adgilnt:   dilating
adgilnu:   lauding, languid, alluding
adgilnv:   invaliding
adgilnw:   waddling, dawdling
adgilny:   dallying
adgilnz:   dazzling
adgilty:   digitally
adgiluy:   gaudily
adgimnp:   damping
adgimnr:   admiring
adgimnt:   mandating, intimidating, admitting
adgimnx:   admixing
adgimor:   radiogram
adgimpr:   paradigm
adginor:   radioing, ordaining, dragooning, adorning, adoring
adginot:   indignation, donating
adginov:   avoiding
adginoz:   anodizing
adginpr:   parading, draping
adginpt:   adapting
adginrt:   trading, radiating, irradiating, gradating, darting
adginru:   guarding, guardian
adginrw:   warding, drawing, awarding
adginrz:   aggrandizing
adgintu:   inundating, daunting, auditing
adgintv:   divagating, advantaging
adgjlru:   guadalajara
adglnru:   glandular
adglnry:   grandly
adglory:   gaylord
adglruy:   gradually
adgnopr:   propaganda
adgnoru:   aground
adgnory:   organdy, androgyny
adgnruv:   vanguard
adhilnr:   handrail
adhilnt:   thailand
adhilnv:   havilland
adhilny:   handily
adhilop:   haploid
adhiloy:   holiday
adhinop:   ophidian
adhinor:   rhodian
adhinot:   nationhood
adhinpu:   dauphin
adhinuy:   hyundai
adhirtw:   withdraw
adhlotu:   adulthood
adhmnow:   womanhood
adhnoru:   honduran
adhnotu:   handout
adhnrty:   hydrant
adhoprt:   hardtop, arthropod
adijnor:   jordanian
adilmno:   mandolin
adilmnr:   mandrill
adilmnt:   dalmatian
adilmnu:   maudlin
adilmop:   diploma
adilmor:   armadillo
adilmov:   moldavia
adilmpu:   palladium
adilnor:   radiolarian, ordinal, doornail
adilnot:   dilation, dilatation, additional
adilnpr:   lapidarian
adilnru:   diurnal
adilntu:   latitudinal, attitudinal
adilntw:   tailwind
adilnty:   daintily
adilnuv:   individual
adilopr:   polaroid
adilort:   dilator
adilpry:   rapidly, lapidary
adilptu:   plaudit
adilpvy:   vapidly
adilrty:   tardily
adiltuy:   duality
adiltvy:   validity
adimnor:   radioman, mondriaan
adimnot:   intimidation, domination, dominant, damnation, admonition
adimnrt:   tamarind
adimnry:   dairyman
adimnuv:   vanadium
adimpry:   pyramid
adinopr:   raindrop, poniard, paranoid
adinopt:   adoption, adaptation
adinort:   tradition, tandoori, radiation, ordination, irradiation, adoration
adinory:   ordinary
adinotu:   inundation, audition
adinotv:   divination
adinotx:   oxidation, oxidant, antioxidant
adioprt:   parotid
adiortu:   auditor
adiprty:   rapidity
adiptvy:   vapidity
adirwyz:   wizardry
adjnoru:   adjourn
adklmnr:   landmark
adklnpr:   parkland
adklorw:   workload
adklrwy:   awkwardly
adkmntu:   katmandu
adkorwy:   workday, workaday
adlmnor:   moorland
adlmnry:   maryland
adlmnty:   adamantly
adlmoru:   modular
adlnoru:   nodular
adlnotu:   outland
adlnruy:   laundry
adlortu:   adulator
admnoqu:   quondam
admnort:   mordant, dormant
admnory:   raymond, normandy
admnrty:   mandatary
admopru:   pompadour
admorty:   martyrdom
adnopwy:   pandowdy
adnoqru:   quadroon
adnortu:   turnaround, rotunda
adnorty:   drayton, donatory
adnqrtu:   quadrant
adnqruy:   quandary
adortuw:   outward
aefgiln:   leafing, finagle
aefgilo:   foliage
aefgilr:   fragile
aefginr:   refraining, fearing, affeering
aefgint:   fattening
aefgior:   fairgoer
aefgirt:   refrigerate, frigate
aefgitu:   fatigue
aefglmu:   flagellum
aefglno:   longleaf
aefglnt:   flagellant
aefglop:   flagpole
aefglot:   flotage, flageolet
aefglow:   flowage
aefgnrt:   engraft
aefgort:   footgear
aefgorv:   forgave
aefhint:   antitheft
aefhlrt:   heartfelt
aefhltu:   healthful, hateful
aefhmrt:   aftermath
aefhort:   forefather
aefhrtw:   whereafter
aefhrty:   feathery
aefiklr:   flakier
aefikmn:   knifeman
aefiknr:   afrikaner
aefilmn:   inflame, filename
aefilnr:   infernal
aefilnt:   inflate, infantile
aefilnz:   finalize
aefilot:   foliate, fellatio
aefilrt:   filtrate, afterlife
aefilru:   failure
aefilrw:   firewall
aefiltu:   fauteuil
aefiluv:   effluvial, effluvia
aefimnr:   mainframe, fireman
aefimnt:   effeminate
aefimor:   foamier
aefimrw:   firmware
aefinot:   fenatio
aefinrt:   fainter
aefintu:   infatuate
aefiprt:   firetrap, aperitif
aefiqru:   aquifer
aefitvx:   fixative
aefkluw:   wakeful
aeflmor:   femoral
aeflnot:   fontanel
aeflnrt:   fraternal
aeflnru:   funereal, funeral
aeflntu:   flatulent, affluent
aeflopw:   peafowl
aeflort:   floater
aeflorv:   overleaf
aeflorw:   wallflower
aeflpry:   palfrey, flypaper
aeflptu:   plateful
aeflrtu:   tearful, aflutter
aeflrtw:   waterfall, flatware
aeflrty:   flattery
aeflrux:   flexural
aeflruy:   fearfully
aefltuy:   fatefully
aefmnor:   forename, foreman, foramen
aefmnry:   ferryman
aefmort:   reformat, formatter
aefnopr:   profane
aefnort:   afternoon
aefnorw:   forewarn
aefnruy:   funerary
aefoprt:   perforator, perforate, forepart
aefoprw:   forepaw
aefortw:   footwear
aeghiln:   healing
aeghilr:   raleigh
aeghinp:   heaping, happening
aeghinr:   rehearing, hearing
aeghint:   heating
aeghinv:   heaving
aeghinw:   heehawing
aeghipr:   epigraph
aeghirt:   heritage
aeghlno:   halogen
aeghlor:   logorrhea
aeghlru:   laugher
aeghmor:   homager, hemorrhage
aeghmpr:   grapheme
aeghmrx:   hexagram
aeghnor:   gonorrhea
aeghnox:   hexagon
aeghnru:   haranguer, harangue
aeghopr:   geographer
aeghort:   theatergoer
aeghoru:   roughage
aegikln:   linkage, leaking
aegiknp:   peaking
aegiknw:   weakening, wakening, awakening
aegikrw:   gawkier
aegilmn:   liegeman, gleaming, enameling
aegilmt:   legitimate, illegitimate
aegilnp:   pealing, paneling, leaping, lagniappe, enplaning, appealing
aegilnr:   regaling, realleging, realigning, realign, learning, ganglier, enlarging, algerian
aegilnt:   tangential, inelegant, genitalia, genital, gelatin, galantine, entangling, entailing, elating, eglantine, alienating, alginate
aegilnu:   leaguing
aegilnv:   leaving, leavening
aegilny:   genially, engagingly
aegilnz:   legalizing
aegilpr:   pillager, paraplegia, papergirl
aegilrt:   aglitter
aegilru:   irregular, guerrilla
aegilrv:   villager
aegilrz:   glazier
aegilty:   legality, illegality
aegimnr:   renaming, remaining, rearming, reaming, migraine, menagerie, margarine, mangier
aegimnt:   teaming, mintage, magnetite, geminating, geminate, emanating
aegimnu:   unmeaning
aegimnx:   examining
aegimnz:   magazine
aegimor:   maggiore
aegimpr:   primage, epigram
aegimpt:   pegmatite
aegimrt:   ragtime, migrate, immigrate, emigrate
aegimry:   imagery
aeginor:   nonagenarian, ignorare, gregorian, georgian
aeginot:   negotiation, negotiating, negotiate, negation
aeginoz:   agonize
aeginpr:   repairing, reappearing, reaping, preparing, prearranging, papering, appearing
aeginpt:   patenting, paginate
aeginrt:   treating, tearing, tattering, targeting, tangier, tangerine, retreating, retraining, retaining, reiterating, reintegrating, reintegrate, regranting, regenerating, rattening, nattering, iterating, integrating, integrate, integrant, integra, ingratiate, ingrate, granite, girante, generating, entreating, entraining, entertaining, argentite, argentinian, argentinean, argentine, argentina, aggregating, aerating
aeginru:   rearguing
aeginrv:   vinegar, ravening, engraving, averring, averaging, aggrieving
aeginrw:   wearing, wagnerian, wagering
aeginry:   yearning, gainery
aegintu:   attenuating
aegintv:   vintage, vegetating, negative, navigate
aegintz:   gazetting
aeginvw:   weaving
aegiopr:   arpeggio
aegipqu:   equipage
aegirtu:   regurgitate
aegirtv:   virgate, variegate, gravitate
aegkmpr:   gamekeeper
aegkprt:   gatekeeper
aeglmnt:   gentleman, entanglement
aeglmnv:   gavelmen, gavelman
aeglmpu:   plumage
aeglmrt:   telegram
aeglmry:   meagerly
aeglmtu:   guatemala, glutamate
aeglnor:   organelle, algernon
aeglnot:   tangelo, elongate
aeglnou:   analogue
aeglnoy:   genealogy
aeglnpr:   grapnel
aeglnpt:   plangent, pentangle, eggplant
aeglnru:   granule
aeglnrw:   wrangler, wrangle
aeglnry:   laryngeal, generally
aeglntu:   untangle, ungulate, gauntlet
aeglnty:   elegantly
aeglnuw:   gunwale
aeglopr:   pergola
aeglort:   legator, gloater
aeglorv:   overlarge
aeglory:   gargoyle, allegory
aeglotv:   voltage
aeglpru:   earplug
aeglrtu:   regulate
aeglrtx:   extralegal
aeglrty:   legatary, greatly, aggregately
aeglruy:   regularly
aeglrvy:   gravely
aegltuv:   vulgate
aegluvy:   vaguely
aegmnor:   orangemen, orangeman
aegmnot:   montage, megaton, magneto
aegmnrt:   termagant, rearrangement, garment, arrangement, agreement
aegmnrv:   gravamen
aegmnry:   germany
aegmntu:   augment
aegmopr:   reprogram, programmer
aegmort:   mortgagee, mortgage
aegmoxy:   exogamy
aegmrtu:   ageratum
aegnopt:   pentagon
aegnort:   regenerator, generator
aegnory:   orangery
aegnprt:   pregnant, parentage
aegnrtu:   unregenerate, guarantee, gaunter
aegnruv:   auvergne
aegoprt:   reportage, propagate, porterage, portage
aegortu:   outrage
aegortx:   exaggerator
aegorvy:   voyager
aegorvz:   overgraze
aehijmr:   jeremiah
aehilnr:   inhaler, hairline
aehilnt:   nathaniel, annihilate
aehilny:   hyaline
aehilpr:   peripheral, perihelia, harelip
aehilpt:   epithelial
aehilrt:   triathlete, healthier
aehiltw:   whitewall, whitehall
aehilty:   lethality, hyalite, healthily
aehilvy:   heavily
aehimnu:   inhumane
aehimpr:   ephraim
aehinpr:   heparin
aehinpy:   epiphany
aehinpz:   zephaniah
aehiopt:   ethiopia
aehiort:   throatier
aehirwy:   haywire
aehklnt:   kathleen
aehkmor:   homemaker
aehlmno:   manhole
aehlmny:   hymeneal
aehlmor:   armhole
aehlmpr:   ephemeral
aehlmpt:   pamphlet, helpmate
aehlmrt:   thermal
aehlnop:   allophone
aehlnot:   ethanol
aehlnow:   halloween
aehlnpt:   naphthalene, elephant
aehlnrt:   enthrall
aehlnvy:   heavenly
aehlopr:   phalarope
aehlorw:   hollowware
aehlpty:   telepathy
aehlpuv:   upheaval
aehlrty:   tetraethyl, leathery, lathery, ethereally, earthly
aehltwy:   wealthy
aehmnop:   phenomena
aehmnor:   menorah, amenorrhoea
aehmntu:   athenaeum
aehmopr:   amphorae
aehmopt:   homeopath, apothem
aehmprt:   heptameter
aehmpty:   empathy
aehmrtx:   hexameter
aehnopr:   harpooner, earphone
aehnopt:   phaeton, pantheon
aehnort:   another
aehnorv:   hanover
aehnoty:   hootenanny
aehnprt:   panther
aehnpty:   hyphenate
aehnrtu:   urethane, unearth
aehnrtw:   earthenware
aehnrtx:   narthex
aehnrtz:   nazareth
aehnrwy:   anywhere
aehopry:   pyorrhea
aehortv:   overheat
aehprty:   therapy
aehrtvw:   whatever
aeijlnv:   javelin
aeijnor:   janeiro
aeiklmn:   manlike
aeiklmu:   leukemia
aeiklnr:   lankier
aeiklnz:   alkalinize
aeiklrw:   warlike
aeikltv:   talkative
aeiklvw:   wavelike
aeikmnr:   ramekin
aeiknrt:   keratin
aeiknru:   ukraine
aeikrty:   teriyaki
aeilmnp:   maniple, impanel
aeilmnr:   mineral, millenarian, marline, manlier
aeilmnt:   militiamen, lineament, laminate, entailment, eliminate, alimenta, aliment, ailment
aeilmny:   menially
aeilmor:   memorial, immemorial
aeilmot:   immolate
aeilmpr:   imperial
aeilmqu:   aliquem
aeilmrt:   remittal, militare, materiel, material, immaterial, altimeter
aeilmtu:   ultimate, mutilate, multimate
aeilmtw:   willamette
aeilmtz:   lemmatize
aeilnor:   alienor, aileron
aeilnot:   toenail, intentional, elation, alienation
aeilnpr:   praline, plainer, perennial, airplane
aeilnpt:   penitential, palatine, palatinate
aeilnpx:   explain
aeilnpz:   penalize
aeilnqu:   aquiline
aeilnrt:   triennial, retinal, reliant, ratline, latrine, interrelate, internal, interlinear, inertial
aeilnrv:   valerian
aeilnry:   linearly
aeilntu:   lieutenant, aleutian
aeilntv:   ventilate, valentine
aeilnty:   innately
aeilntz:   tantalize, initialize
aeilnuv:   univalve
aeilnuz:   annualize
aeilnvy:   venially, naively
aeilort:   territorial, retaliator, arteriole
aeilotv:   volatile, violate
aeilotz:   totalize
aeilpqu:   applique
aeilprt:   preliterate, parietal, paltrier
aeilprv:   prevail, paravaile
aeilptv:   palliative
aeilptz:   palletize, palatalize
aeilqtu:   tequila
aeilquz:   equalize
aeilrtu:   literature
aeilrtv:   retrieval, relative, alliterative
aeilrty:   trilaterally, reality, literary, literally, laterality, irately, artillery
aeilrwy:   wearily
aeiltuv:   evaluative
aeiltvx:   laxative
aeiltvz:   vitalize
aeimnor:   romaine, moraine
aeimnot:   nominate, innominate, emanation, ammonite
aeimnpr:   repairmen, repairman, permian
aeimnpt:   impatient
aeimnqu:   mannequin
aeimnrt:   terminate, reanimate, raiment, minaret, martinet, marinate, maintainer, entertainment
aeimnrv:   venireman, minerva
aeimnrx:   examiner
aeimntu:   minutiae, minuteman
aeimntv:   vietnam
aeimnty:   anytime, amenity
aeimopr:   emporia
aeimotv:   motivate
aeimotx:   toxemia
aeimotz:   atomize
aeimprt:   primate
aeimprv:   vampire
aeimrtu:   terrarium, immature
aeimrtw:   wartime
aeimrtx:   taximeter
aeimtuv:   mutative
aeinopt:   potentia, appointee
aeinort:   reorientation, reiteration, ratione, orientation, orientate, iteration, anterior, aeration
aeinorw:   ironware
aeinorx:   anorexia
aeinotu:   attenuation
aeinotv:   venation, venatio, novitiate, innovative, innovate
aeinotw:   newtonian
aeinotx:   annexation
aeinprt:   terrapin, repaint, pertain, pentair, painter, interpenetrate, appertain
aeinptu:   petunia
aeinqtu:   aquitaine, antique, antiquate
aeinrtu:   urinate
aeinrtv:   veterinarian, travertine, narrative, inveterate
aeinrtw:   tawnier
aeinrty:   itinerary
aeintvy:   naivety
aeintxy:   anxiety
aeioprt:   propitiate, pretoria, appropriate
aeiprtv:   reparative, privative, privateer, private, preparative, partitive
aeiprtw:   wiretap
aeiprtx:   extirpate, expatriate
aeiprtz:   appetizer
aeipruz:   pauperize
aeiptuv:   putative
aeiqrtu:   quietare
aeirtuz:   azurite
aeirtvy:   variety
aejkrtw:   jerkwater
aejmort:   majorette
aeklmrw:   lawmaker
aeklmry:   malarkey
aekmrtw:   watermark
aeknprt:   partaken
aeknptw:   wapentake
aeknrvy:   knavery
aekoprw:   paperwork
aekortv:   overtake
aelmnop:   monoplane
aelmnor:   almoner
aelmnot:   allotment
aelmnpt:   nameplate
aelmnrt:   maternal, maltreatment
aelmnru:   numeral
aelmnry:   mannerly
aelmntu:   annulment
aelmnty:   mentally, elementally, allayment
aelmopr:   premolar, palermo
aelmopt:   palmetto
aelmopu:   ampoule
aelmopy:   maypole
aelmorv:   valorem, removal
aelmorz:   mozzarella
aelmoty:   tomalley
aelmprt:   trample, templar
aelmprx:   exemplar
aelmpry:   lamprey
aelmpty:   playmate
aelnopt:   antelope
aelnort:   tolerant, alternator
aelnoru:   neuronal
aelnpqu:   aquaplane
aelnprt:   replant, prenatal, planter, paternal, parentela, parental
aelnprw:   warplane
aelnpry:   plenary
aelnptu:   petulant, antepenult
aelnpty:   penalty, patently, aplenty
aelnquy:   unequally
aelnrtu:   unlearnt, renault, neutral, naturel, naturale
aelnrtv:   ventral, tetravalent, relevant
aelnrtx:   relaxant, external
aelnrty:   eternally, alternately
aelnruv:   unravel
aelnrvy:   vernally
aelnryz:   analyzer
aelntuv:   eventual
aelntux:   exultant
aelnuvz:   venezuelan, venezuela
aeloprt:   patroller, allotrope
aeloprv:   overleap, overlap
aelopry:   propylaea
aeloptu:   populate
aelopxy:   apoplexy
aelortv:   elevator
aelortw:   waterloo
aelorty:   aleatory
aelortz:   lazaretto
aeloruv:   overvalue
aelorvy:   overlay, layover
aelotuv:   ovulate
aelprtu:   perpetual
aelpryz:   paralyze
aelqtuz:   quetzal
aelrtuv:   vaulter, revaluate
aelrtux:   textural
aelrtuy:   tutelary
aelrtwz:   waltzer
aeltuxy:   textually
aemnort:   ornament, manometer, attornment, anteroom, anemometer
aemnorv:   overman
aemnory:   anymore
aemnotz:   metazoan
aemnprt:   temperament, permanent, pentameter, entrapment, apartment
aemnpry:   empyrean
aemnptv:   pavement
aemnpty:   payment
aemnrtu:   remunerate, numerate, enumerate
aemnrtv:   averment
aemnruv:   maneuver
aemnrvy:   everyman
aemoprt:   tempora
aemortu:   mortuae
aemprtu:   tempura, temperature, premature
aenoprt:   protean
aenopru:   european
aenortu:   aeronaut
aenortv:   venerator, renovator, renovate, overeaten
aenortx:   exonerate
aenorty:   attorney
aenorvw:   ovenware
aenouvx:   nouveaux
aenprtu:   unrepentant, enrapture, appurtenant
aenprtw:   antwerp
aenpruv:   parvenu
aenqrtu:   quarentena
aeoprtu:   perpetuator
aeoprtv:   evaporator, evaporate
aeoprty:   preparatory, portrayer
aeoprvw:   vaporware
aeoprvy:   overpay
aeoqrtu:   quorate, equator
aeoqruv:   vaquero
aeortuw:   outwear, outerwear
aeortvx:   overtax
aepqrtu:   parquet
aeprtuw:   tupperware
aeprtxy:   taxpayer
afghint:   hafting
afghirt:   affright
afghrtu:   fraught
afgikln:   flanking, flaking
afgiknr:   franking
afgilmn:   inflaming, flaming
afgilno:   loafing, foaling
afgilnp:   flapping
afgilnr:   raffling, flaring
afgilnt:   inflating, flatting, filiating, affiliating
afgilnu:   unflagging, unfailing, gainful
afgilnw:   waffling
afgilny:   flaying
afgilnz:   finalizing
afgilru:   figural
afgimno:   foaming
afgimnr:   framing, farming, affirming
afgimny:   magnifying, magnify
afginor:   foraging
afginpr:   frangipani
afginqu:   quaffing
afginrt:   rafting, grafting, farting
afginry:   fraying
afgintu:   infatuating, fatiguing
afgintw:   wafting
afgintx:   fixating
afginuw:   guffawing
afgiort:   graffito
afgirty:   gratify
afglnrt:   flagrant
afglruy:   frugally
afgmnor:   frogman
afgortu:   fugator
afhiltu:   faithful
afhimnu:   hafnium
afhlmru:   harmful
afhloty:   hayloft
afiklnr:   franklin
afilmpy:   amplify
afilmry:   familiarly
afilnop:   fallopian
afilnot:   inflation, foliation, flotation, floatation, filiation, affiliation
afilnpt:   plaintiff, flippant
afilnpu:   painful
afilntv:   infinitival
afilnty:   finality, faintly
afilorw:   airflow
afilquy:   qualify
afilrty:   fritillary, frailty
afimnor:   foramina
afimnrt:   affirmant
afimnry:   infirmary
afinopr:   rainproof
afinotu:   infatuation, fountain
afinotx:   fixation
afinrty:   infantry
afklnry:   frankly
afklntu:   tankful
afklowy:   folkway
afkmort:   footmark
afknort:   frankfort
afknrtu:   frankfurt
aflmnuy:   manfully
aflmoru:   formula
aflmorw:   wolfram
aflmory:   formally
aflnort:   frontal
aflnuwy:   unlawfully
aflprty:   flytrap
aflrtuy:   artfully
aghiknr:   harking
aghiknt:   thanking
aghiknw:   hawking
aghilno:   hooligan, hallooing
aghilnt:   hightailing, halting, annihilating, alighting
aghilnu:   laughing, hauling
aghilnv:   halving
aghilnw:   whaling
aghilot:   goliath
aghilrt:   alright
aghimnr:   harming
aghimnw:   whamming
aghinox:   hoaxing
aghinpr:   paragraphing, harping, graphing
aghinru:   hurrahing, hungarian, haranguing
aghinry:   harrying
aghintu:   haunting
aghintw:   thawing
aghinty:   anything
aghkmny:   gymkhana
aghlmor:   hologram
aghlopr:   olograph, holograph, allograph
aghlotu:   although
aghmnoy:   mahogany
aghmopr:   homograph
aghnopr:   phonograph
aghnotu:   hangout
aghnruy:   hungary
aghntuy:   naughty
aghoprt:   photograph
aghortw:   warthog
agijntu:   jaunting
agiklnp:   planking
agiklnr:   rankling, larking
agiklnt:   talking
agiklnw:   walking
agiklnz:   alkalizing, alkalinizing
agikmnr:   marking
agikmnu:   unmaking
agiknoy:   okaying, kayoing
agiknpr:   parking
agiknqu:   quaking
agiknty:   tanganyika
agilmno:   mongolian, mongolia, magnolia, gloaming
agilmnp:   palming, impaling
agilmnr:   marling, marginalia, marginal, alarming
agilmnt:   militating, mantling, malting, malignant, laminating, amalgamating
agilmnu:   mulligan, mauling
agilmpu:   palagium
agilnop:   pangolin, galloping
agilnor:   original
agilnot:   totaling, litigation, intaglio, inlagation, gloating, allotting
agilnow:   wallowing, allowing
agilnox:   gloxinia
agilnoy:   annoyingly, alloying
agilnoz:   analogizing
agilnpr:   pillaring, grappling
agilnpt:   platting, plating, planting, plaiting, palpitating, palpating, palliating
agilnpu:   plaguing
agilnpw:   lapwing
agilnpy:   playing, applying, appallingly
agilnqu:   quailing
agilnrt:   trailing, rattling
agilnru:   inaugural, alluring
agilnrv:   virginal, rivaling
agilnrw:   wrangling
agilnry:   rallying, grayling, glaringly, angrily
agilntu:   untangling, ululating, agglutinin, agglutinating
agilntv:   vigilant, invigilating, gallivanting, gallivant
agilnty:   tallying
agilntz:   tantalizing, initializing
agilnuv:   valuing, unavailing
agilnuy:   ungainly
agilnuz:   annualizing
agilnvy:   vaginally
agilnvz:   galvanizing
agilnwy:   yawningly, waylaying
agilnyz:   analyzing
agilort:   alligator
agilotv:   gigavolt
agilpry:   playgirl, plagiary
agimnor:   roaming, marooning, armoring
agimnot:   nominating, mitigation, imagination
agimnpr:   rampaging, impairing
agimnpt:   tamping
agimnpv:   vamping
agimnrt:   migrating, migrant, marinating, immigrating, immigrant
agimnru:   rummaging
agimnrv:   gravamina
agimnrw:   warming
agimnry:   marrying, imaginary
agimntu:   mutating, manumitting
agimnty:   magnanimity
agimnxz:   maximizing
agimpru:   paragium
aginopt:   poignant, patagonian, patagonia, pagination, appointing
aginort:   rotating, rogation, rigatoni, rationing, originator, origination, originating, orating, irrigation, ignoratio, ignorantia, ignorant, garroting, attorning, arrogation, arrogating
aginorw:   narrowing
aginorz:   organizing
aginotv:   navigation, innovating
aginotz:   antagonizing
aginovw:   avowing
aginovy:   voyaging
aginowy:   waygoing
aginprt:   trapping, prating, pirating, parting
aginprw:   wrapping, warping
aginpry:   praying, parrying
aginptu:   pupating
aginqtu:   aquatinting, antiquating
aginrtu:   urinating, inaugurating
aginrtv:   gravitating, aggravating
aginrtw:   warranting
aginrty:   tarrying, gyrating
aginrvy:   varying
agintuv:   vaunting
agirtuy:   gratuity
agirtuz:   ziggurat
agirtvy:   gravity
aglmopy:   polygamy
aglmoru:   glamour
aglnopy:   polygonal
aglnoru:   languor
aglnorz:   gorgonzola
aglnpuy:   gunplay
aglnrty:   gallantry
aglnruy:   granularly
aglntuy:   ungallantly, gauntly
aglotuy:   tautology
aglrtuy:   gutturally
aglruvy:   vulgarly
agmnory:   agronomy
agnortu:   orangutan, guarantor, argonaut
agnpruy:   paraguayan
agnrtuy:   guaranty
ahilmny:   himalayan
ahilmtu:   thallium
ahilnot:   inhalation, halation, annihilation
ahilntu:   lithuanian, lithuania
ahilrty:   hilarity
ahimnru:   marihuana
ahimntw:   whitman
ahimopt:   hippopotami
ahimrty:   arrhythmia
ahimtuz:   azimuth
ahimtvz:   mitzvah
ahinopt:   antiphon
ahinpty:   antipathy
ahinrtu:   arthurian
ahkmotw:   tomahawk
ahknrty:   kathryn
ahlmnor:   hormonal
ahlmntu:   lanthanum
ahlmnuy:   humanly
ahlmopr:   allomorph
ahlmopy:   lymphoma
ahlnort:   althorn
ahlorty:   harlotry
ahmnopt:   phantom
ahmnort:   marathon
ahmnory:   harmony
ahnortw:   hawthorn
ahnprxy:   pharynx
ahoprtu:   autoharp
ahoprty:   atrophy
ahrtuwy:   thruway
aijknou:   kinkajou
aijlovy:   jovially
aijmnru:   marijuana
aijnopy:   popinjay
aijnort:   janitor
aiklnty:   alkalinity
aiklotw:   kilowatt
ailmnop:   palomino, monopolia
ailmnor:   monorail, manorial
ailmnot:   motional, limitation, lamination, immolation
ailmnoy:   nominally, alimony
ailmnpt:   implant
ailmnry:   marilyn
ailmnty:   militantly
ailmopt:   optimal
ailmopy:   olympia
ailmort:   immortal, immolator
ailmory:   immorally
ailmprt:   impartial
ailmpry:   primarily
ailmrty:   military, militarily, martially
ailmrxy:   maxillary
ailmtuy:   mutuality
ailnopt:   pollination, plantation, palpitation, palpation, palliation, optional
ailnopv:   pavilion
ailnort:   totalitarian, rotational, rational, notarial, irrational
ailnotu:   ululation, lunation
ailnotv:   volitional, violation, invitational
ailnotw:   alwinton
ailnoty:   tonality, nationally, nationality, atonality
ailnotz:   tantalization, nationalization, initialization
ailnouv:   alluvion
ailnpqu:   palanquin
ailnptu:   nuptial, lilliputian
ailnpty:   ptyalin
ailnqtu:   quintal
ailnrtu:   utilitarian
ailntvy:   valiantly
ailoprt:   raptorial
ailoptu:   autopilot
ailoptv:   pivotal
ailoqtu:   aliquot
ailortu:   tutorial
ailortv:   violator
ailorux:   uxorial
ailotvy:   volatility
ailprty:   partially, partiality
ailqtuy:   quality
ailrtuv:   virtual
ailrtuy:   ritually
ailrtvy:   trivially, triviality
ailruxy:   auxiliary
aimnopt:   maintop
aimnort:   nominator, mortmain, animator
aimnorv:   monrovia, monravia
aimnotu:   mutation, mountain, automation, ammunition
aimnotv:   motivation
aimnoty:   antinomy, antimony, anonymity
aimnotz:   minimization, atomization
aimnprz:   marzipan
aimnrtu:   ruminant, mauritian, mauritanian, mauritania
aimnrtv:   varmint
aimntuy:   unanimity
aimoprx:   proxima
aimortu:   moratorium
aimorty:   moriarty
aimoruv:   variorum
aimprtu:   partium, imprimatur
aimprty:   imparity
aimrtuy:   maturity, immaturity
ainoprt:   proration, propitiation, partition, appropriation, apportion, appointor, apparition, antiproton
ainoptu:   utopian, pupation
ainoqtu:   quotation, antiquation
ainortu:   urination, ruination
ainortv:   variation, innovator
ainotuz:   unitization, unionization
ainpqtu:   piquant
ainprtu:   puritan
ainqrtu:   quatrain, antiquarian
ainqtuy:   quantity, antiquity
ainrtuy:   unitary
aioprty:   topiary, propitiatory
aiprtuy:   pituitary
ajlnoru:   journal
ajmnruy:   juryman
aklnopt:   plankton
aklotuw:   walkout
akmnorw:   workman
aknortu:   outrank
almnopr:   paranormal
almnoru:   unmoral, monaural
almnory:   normally
almnowy:   womanly, laywoman
almopry:   playroom
almorty:   mortally, mayoralty
alnopru:   unpopular
alnoptu:   pollutant
alnopty:   polytonal
alnorwy:   narrowly
alnotwy:   wantonly
alnrtuy:   unnaturally, naturally
aloprty:   prototypal, portrayal, allotropy
alopruy:   popularly
aloptuy:   outplay
alortuv:   valuator
alortvy:   lavatory
amnotuy:   autonomy
amnotxy:   taxonomy
amnptuy:   tympanum
amnqruy:   quarryman
amoprty:   protomartyr
amortuy:   mortuary
anoprty:   pronotary
anoprtz:   protozoan
bcdehir:   herbicide
bcdehit:   bitched
bcdehln:   blenched
bcdehnu:   bunched
bcdehot:   botched
bcdeikr:   bricked, bickered
bcdeilm:   climbed
bcdeilr:   credible
bcdeilu:   educible, deducible
bcdeily:   bicycled
bcdeino:   obedience
bcdeint:   benedictine, benedict
bcdejot:   objected
bcdeklo:   blocked
bcdeklu:   buckled
bcdekno:   beckoned
bcdekor:   bedrock
bcdektu:   bucketed
bcdelor:   clobbered
bcdelou:   beclouded, becloud
bcdemru:   cumbered, crumbed
bcdenou:   bounced
bcdeorv:   bedcover
bcdeoty:   boycotted
bcdiklu:   duckbill
bcdimor:   bromidic
bcdinru:   rubicund
bcdiorw:   cowbird
bcdklow:   woodblock
bcdkoru:   burdock
bcefikr:   firebrick
bcefint:   beneficent
bceghin:   benching
bcehior:   brioche
bcehirt:   bitchier
bcehiru:   chubbier, cherubic
bcehitw:   bewitch
bcehkno:   cheekbone
bcehktu:   buckteeth
bcehlru:   blucher
bcehort:   brochette
bcehoru:   brochure
bcehrtu:   butcher
bceilmo:   embolic
bceilmr:   climber
bceilnu:   ebullience
bceilnv:   invincible, evincible
bceilor:   coercible
bceilot:   collectible, botticelli
bceilru:   crucible
bceimno:   combine
bceimor:   microbe
bceinot:   cenobite
bceinou:   concubine
bceinoz:   benzoic
bcejort:   objector
bceklru:   buckler
bceknru:   rubberneck
bcekopt:   pocketbook
bcekoru:   roebuck
bcekqru:   quebecker
bcelmru:   crumble, cerebellum
bcelnov:   benevolence
bcelrtu:   tubercle
bcemnru:   recumbence, encumber
bcenoru:   bouncer
bceprtu:   buttercup
bcflotu:   clubfoot
bcghint:   bitching
bcghinu:   bunching
bcgiknr:   bricking
bcgiknu:   bucking
bcgilmn:   climbing
bcgilno:   cobbling
bcgilnu:   clubbing
bcgilny:   bicycling
bcgimno:   combining, combing
bcginou:   bouncing
bcginru:   curbing
bchilty:   bitchily
bchimop:   homophobic
bchimor:   rhombic
bchinor:   bronchi
bchiory:   choirboy
bchkotu:   bucktooth
bchloty:   blotchy
bciklot:   bootlick
bcikorw:   brickwork
bcilmou:   columbium
bcilnvy:   invincibly
bcilpuy:   publicly
bcimoru:   ciborium
bcinoru:   rubicon
bcirtuy:   butyric
bcklnou:   unblock
bclmoru:   clubroom
bclmruy:   crumbly
bdefilo:   lifeblood
bdefinr:   befriended, befriend
bdefint:   benefited
bdeflmu:   fumbled
bdeflou:   befouled
bdeflow:   bedfellow
bdeghmu:   humbugged
bdegiln:   blending, bleeding
bdegilo:   obliged
bdegilr:   dirigible
bdegilu:   beguiled
bdegimn:   imbedding, embedding
bdegimr:   bembridge, begrimed
bdeginr:   rebinding, inbreeding, breeding, begirding
bdegint:   debiting, betiding
bdeginu:   unbending, debugging
bdeginw:   bedewing
bdeginz:   bedizening
bdegiot:   bigoted
bdegirt:   bridget
bdeglno:   boondoggled, boondoggle, belonged
bdeglnu:   bungled
bdeglot:   bootlegged
bdeglou:   doodlebug, bulldogged
bdeglru:   burgled
bdehint:   inhibited
bdehirt:   birthed
bdehitx:   exhibited
bdehlmu:   humbled
bdehlno:   beholden
bdehlor:   beholder
bdehloy:   hobbledehoy
bdehlrt:   blethered
bdehmoy:   homebody
bdehmtu:   thumbed
bdehort:   throbbed, brotherhood, bothered, betrothed
bdeikln:   blinked
bdeiklr:   birdlike
bdeiktz:   kibitzed
bdeilmr:   limbered
bdeilno:   bloodline
bdeilnr:   blinder
bdeilnu:   unbilled
bdeilnv:   vendible
bdeilny:   indelibly
bdeilor:   broiled, bloodier
bdeilow:   billowed
bdeilox:   bollixed
bdeilqu:   quibbled
bdeilrt:   driblet
bdeilru:   rebuild, builder, bluebird
bdeilrw:   bridewell, bewildered, bewilder
bdeilty:   edibility, debility
bdeiltz:   blitzed
bdeimor:   embroidered, embroider, bromide
bdeimrt:   timbered, embittered
bdeimru:   imbrued
bdeinor:   beribboned
bdeinot:   obedient
bdeinou:   bedouin
bdeinow:   woodbine
bdeinrt:   interbreed, interbred
bdeinru:   underbid, unburied
bdeinry:   bindery
bdeinrz:   benzedrine
bdeiort:   orbited, debitor
bdeiorv:   overbid
bdeirtu:   bruited
bdeiruz:   rubberized
bdeituy:   dubiety
bdejlmu:   jumbled
bdeknot:   betokened
bdeknru:   bunkered
bdekorv:   overbooked
bdelmno:   emboldened, embolden
bdelmpu:   plumbed
bdelmrt:   trembled
bdelmru:   rumbled, lumbered
bdelmtu:   tumbled
bdelnor:   blonder
bdelnru:   blunderer, blundered, blunder
bdelntu:   unbelted, blunted
bdeloru:   redoubled, redouble, boulder
bdelorv:   overbold
bdelotu:   doublet
bdelouz:   bulldozed, bulldoze
bdelrtu:   blurted
bdemnot:   entombed
bdemnru:   unnumbered, renumbered, numbered
bdemorw:   embowered
bdenoru:   rebounded, rebound, eurobond, bounder
bdenorw:   browned
bdenorz:   bronzed
bdenotu:   undoubted, unbuttoned, buttoned
bdenouw:   unbowed
bdenrtu:   unbuttered, debenture
bdeortu:   redoubt, obtruded, obtrude, doubter
bdeortv:   obverted
bdeoruv:   overdubbed, overdub
bdeoruw:   burrowed
bdeorvy:   everybody
bdeprtu:   perturbed
bdfgnou:   fogbound
bdfilno:   blindfold
bdflotu:   doubtful
bdfmnou:   dumbfound
bdgikno:   bookbinding
bdgiknr:   kingbird
bdgilno:   boondoggling, blooding
bdgilnr:   dribbling, bridling
bdgilnu:   unbundling, bundling, building
bdgilny:   blindingly
bdginor:   brooding
bdginou:   bounding
bdginoy:   bodying
bdginru:   drubbing
bdginry:   birdying
bdgnruy:   burgundy
bdhimor:   rhomboid
bdhlnou:   bloodhound
bdijotu:   djibouti
bdinruw:   windburn
bdknory:   donnybrook
bdkorwy:   bodywork
bdnoruw:   rubdown
bdnotuw:   buttonwood
bdoruwz:   buzzword
befgiln:   enfeebling
befgino:   befogging
befginr:   briefing
befgint:   benefiting, befitting
befgiru:   firebug
befilnu:   unbelief
befilnx:   inflexible
befilrt:   filbert
befilry:   briefly
befilxy:   flexibly
befimor:   firebomb
befinor:   bonfire
befiorx:   firebox
beflmnt:   enfeeblement
beflmru:   fumbler
beflorw:   bellflower
beflouw:   beowulf
beghirt:   brighter
beghlru:   breughel
beghotu:   bethought
begiklr:   kilberg
begiknp:   beekeeping
begilmu:   belgium
begilno:   ignoble, ennobling, belonging
begilnp:   pebbling, bleeping
begilnr:   rebelling
begilnt:   intelligible, billeting, belting, belittling, beetling
begilnu:   beguiling
begilnv:   beveling, believing
begilny:   negligibly, benignly, belying, bellying
begilru:   bulgier, beguiler
begilty:   legibility, illegibility, eligibility
begimnr:   remembering, bemiring, begriming
begimnu:   benumbing
beginor:   bioengineering
beginoy:   obeying
beginrt:   bettering
beginrw:   brewing
beginrz:   breezing
beginty:   benignity
beglmru:   grumbler, grumble
beglnrt:   greenbelt
beglnru:   bungler
beglort:   globetrotter, bootlegger
begmnoy:   bogeymen
begmnru:   nuremberg
begnoru:   burgeon
behiknt:   bethink
behilmt:   thimble
behilno:   holbein
behilop:   bibliophile
behilor:   horrible
behilrt:   blither
behilty:   blithely
behimno:   bonhomie
behinop:   hipbone
behiorv:   herbivore
behlmru:   humbler
behlort:   brothel
behlrtw:   bellwether
behnopx:   xenophobe
behnotv:   beethoven
behnpru:   hepburn
behoprt:   potherb
beiklmo:   bookmobile
beiklnr:   blinker
beiklru:   bulkier
beiklwy:   biweekly
beiknor:   knobbier
beikrtz:   kibitzer
beilmnr:   nimbler
beilmnt:   belittlement
beilmor:   mobilier, embroil
beilmoz:   mobilize, immobilize
beilmru:   liberum
beilnor:   rebellion
beilnow:   bowline
beilnrt:   libertine
beilntu:   ebullient, buntline, bulletin
beilopw:   blowpipe
beiloqu:   oblique
beilort:   trilobite, libretto
beilorw:   wobblier
beilorz:   berlioz
beilotu:   oubliette
beilpty:   plebeity
beilqru:   quibbler
beilrtu:   rebuilt
beilrtv:   revertible
beilrty:   terribly, liberty, bitterly
beilryz:   breezily
beimnor:   bromine
beimntu:   bitumen
beimpru:   bumpier
beimrtu:   terbium
beinorw:   brownie
beinotv:   obvention
beinrtu:   turbine, tribune
beinrty:   inebriety
beiopru:   pourboire
beioqtu:   boutique
beiortv:   overbite
beiqrtu:   briquette
beirtuv:   retributive
beirtvy:   brevity
bejkoux:   jukebox
bejortu:   turbojet
bekmopr:   pembroke
beknoru:   unbroken
beknouw:   unbeknown
bekopry:   pokeberry
belmnot:   ennoblement
belmnow:   noblewomen
belmntz:   embezzlement
belmopr:   problem
belmpru:   plumber
belmrtu:   tumbrel, tumbler
belmruy:   mulberry
belnotv:   benevolent
belnrtu:   turbulent, blunter
belopty:   potbelly
belortu:   trouble
belortx:   letterbox
bemnort:   trombone
bemnorv:   november
benortv:   verboten
beoruvy:   overbuy
beprtuy:   puberty
bfgilnu:   flubbing, bluffing
bfgloru:   bullfrog
bfilmru:   brimful
bflnowy:   flyblown
bghilno:   hobgoblin, hobbling
bghilnt:   blighting
bghimnu:   humbugging
bghinor:   highborn, bighorn
bghinrt:   birthing
bghiorw:   highbrow
bghortu:   brought
bgiklnu:   unblinking, bulking
bgiknor:   brooking
bgiknru:   burking
bgikntz:   kibitzing
bgilmno:   blooming
bgilmnu:   mumbling, bumbling
bgilmor:   imbroglio
bgilmou:   gumboil
bgilnor:   broiling
bgilnot:   bottling, bolting, blotting
bgilnou:   globulin
bgilnow:   wobbling, bowling, blowing, billowing
bgilnox:   bollixing
bgilnoy:   obligingly, lobbying, ignobly
bgilnqu:   quibbling
bgilnru:   burgling, burbling, blurring
bgilntu:   blunting
bgilnty:   bitingly
bgilntz:   blitzing
bgilnuy:   bullying
bgiltuy:   gullibility
bgimnot:   bottoming
bgimnpu:   bumping
bgimnru:   imbruing
bginopr:   probing
bginort:   orbiting
bginorw:   browning, borrowing
bginorz:   bronzing
bginotu:   unbuttoning, buttoning
bginouy:   buoying
bginpru:   upbringing, burping
bginrtu:   bruiting
bginruy:   burying
bgiorty:   bigotry
bglnouw:   blowgun
bhilnor:   hornbill
bhilnot:   billionth
bhilory:   horribly
bhilpuw:   bullwhip
bhimort:   thrombi
bhinort:   inhibitor
bhioprt:   prohibit
bhkmnoy:   hymnbook
biklnot:   inkblot
bikmnpu:   bumpkin
bikmtuz:   kibbutzim
bilmoty:   mobility, immobility
bilmpuy:   bumpily
bilnoty:   nobility
biloruz:   lubrizol
bimopru:   opprobrium
bioprty:   probity
bklnory:   brooklyn
bnortuw:   brownout
cdefhil:   filched
cdefikl:   flicked
cdefikr:   fredrick, frederick
cdefino:   confined, confidence, confided, confide
cdefinr:   indifference, difference
cdefint:   infected, deficient
cdefiny:   deficiency
cdefior:   officered
cdefirt:   rectified, certified
cdefiru:   crucified
cdefitv:   defective
cdefklo:   flocked
cdefklr:   freckled
cdefkor:   defrocked, defrock
cdeflrt:   reflected
cdefnor:   enforced, conferred
cdefnou:   confounded
cdefntu:   defunct
cdefort:   defector
cdefprt:   perfected
cdeghou:   coughed
cdegikm:   gimmicked
cdegikn:   decking
cdegiln:   diligence, declining
cdegimr:   germicide
cdegino:   genocide, encoding, decoding, conceding
cdeginr:   receding, decreeing, cringed
cdegint:   detecting
cdeginu:   educing, deducing
cdeginv:   evidencing, deceiving
cdeginx:   exceeding
cdegiot:   geodetic
cdeglnt:   neglected
cdehikl:   childlike
cdehikn:   chinked, chickened
cdehikt:   thicketed
cdehikw:   chickweed
cdehiln:   clinched
cdehilp:   delphic
cdehimo:   homicide
cdehinp:   pinched
cdehinr:   enriched
cdehiow:   cowhide
cdehipr:   deciphered, decipher, ciphered, chirped
cdehipt:   pitched
cdehipu:   hiccupped, hiccuped
cdehirt:   ditcher, dietrich
cdehitw:   witched, twitched
cdehklo:   lockheed
cdehklu:   chuckled
cdehknp:   henpecked
cdehknu:   unchecked, chunked
cdehkpu:   upchucked
cdehlmu:   mulched
cdehlnu:   unclenched, lunched
cdehlny:   lynched
cdehlot:   clothed
cdehlru:   lurched
cdehltu:   clutched
cdehmnu:   munched
cdehmor:   chromed
cdehnot:   notched
cdehnpu:   punched
cdehnqu:   unquenched, quenched
cdehnrt:   trenched, retrenched, entrenched
cdehnru:   crunched, churned
cdehnrw:   wrenched
cdehopu:   pouched
cdehort:   torched, hectored, crocheted
cdehoru:   crouched
cdehorw:   cowherd, chowder
cdehotu:   touched
cdehouv:   vouched
cdehpry:   cyphered
cdehrtw:   wretched
cdeijno:   conjoined
cdeijnt:   injected
cdeijor:   rejoiced
cdeikln:   clinked
cdeiklp:   pickled
cdeiklt:   tickled
cdeiknp:   picnicked
cdeikpr:   pricked
cdeikpt:   picketed
cdeikrt:   tricked
cdeikrw:   wickeder
cdeilmo:   melodic, domiciled, domicile
cdeilno:   indolence
cdeilnp:   penciled
cdeilnr:   reclined, encircled
cdeilnu:   uninclined, nuclide, included, include
cdeilop:   policed
cdeilor:   recoiled, crocodile
cdeilot:   delicto
cdeilou:   celluloid
cdeiloy:   docilely
cdeilpr:   crippled
cdeilpu:   pellucid
cdeilrt:   dielectric, derelict, deciliter
cdeilru:   ridiculed, ridicule, cuddlier
cdeiltu:   ductile
cdeilvz:   civilized
cdeimno:   incommoded, incommode, demonic, comedienne
cdeimnt:   indictment
cdeimnu:   decennium
cdeimor:   mediocre, dormice
cdeimot:   committed
cdeimou:   duodecimo
cdeimox:   commixed
cdeimpr:   crimped
cdeimrt:   decimeter
cdeimrv:   vermicide
cdeimrz:   mercerized
cdeinor:   endocrine
cdeinot:   occident, noticed, detection, decoction, conditioned, conceited, coincident
cdeinov:   invoiced, inconvenienced, convinced, connived, conceived
cdeinpt:   incepted, centipede
cdeinpx:   expedience
cdeinrt:   interdicted, interdict, interceded, intercede, indirect, indicter
cdeinru:   incurred
cdeintu:   inductee, inducted
cdeintv:   vindictive
cdeinuv:   undeceived, undeceive
cdeiopr:   recopied, periodic
cdeiopu:   occupied
cdeiort:   director, creditor, cordite
cdeiorv:   divorcee, divorced, divorce
cdeiprt:   predicted, predict, decrepit
cdeipru:   pedicure
cdeiprv:   perceived
cdeiptv:   deceptive
cdeirtu:   rectitude, recruited, diuretic, circuited, certitude
cdeirtv:   verdict, directive
cdeirtz:   criticized
cdeituv:   deductive
cdejkoy:   jockeyed
cdejlty:   dejectedly
cdejnou:   jounced
cdeklnu:   knuckled
cdeklou:   cuckolded
cdeklow:   wedlock
cdeklpu:   plucked
cdeknor:   reckoned
cdeknou:   undocked, uncooked
cdeknov:   convoked
cdekopt:   pocketed
cdekort:   rocketed
cdekorv:   overcooked
cdekpru:   puckered
cdekrtu:   tuckered, trucked
cdelmno:   mcdonnell
cdelmop:   compelled, clomped
cdelmow:   welcomed
cdelmoy:   mollycoddled, mollycoddle
cdelmpu:   clumped
cdelmtu:   mulcted
cdelnor:   redolence
cdelnou:   uncooled, unclouded, concluded, conclude
cdelnow:   clowned
cdelnoy:   concededly
cdelnru:   uncurled
cdelntu:   unelected
cdelnty:   decently
cdelnux:   unexcelled
cdelopu:   coupled
cdelort:   recollected, electrode
cdelorv:   overcooled
cdelotu:   occulted, clouted
cdeloty:   collectedly
cdelpru:   precluded, preclude
cdelrtu:   lectured, cultured, cluttered
cdelrux:   excluder
cdelruy:   crudely
cdemnor:   recommended, recommend, recommenced
cdemnot:   contemned, commented
cdemnou:   communed
cdemnow:   comedown
cdemnrt:   decrement
cdemopt:   competed
cdemort:   mcdermott, ectoderm
cdemoru:   decorum
cdemotu:   commuted
cdenopu:   pounced
cdenort:   reconnected, contorted, contendere, contender, concerted
cdenoru:   unrecorded, unconcerned, renounced, denouncer, concurred
cdenorv:   reconvened
cdenorw:   crowned
cdenotu:   uncounted, unconnected, counted, conducted
cdenovy:   convoyed, conveyed
cdenprt:   precedent
cdenpru:   prudence
cdenpry:   precedency
cdenrtu:   undercut, undercurrent
cdentux:   unexecuted
cdeoprt:   protected, proctored
cdeopru:   reproducer, reproduced, reproduce, recouped, producer, produced, produce, procured, procedure
cdeortu:   courted
cdeortv:   vectored, overcorrected
cdeorvw:   overcrowded, overcrowd
cdeprtx:   excerpted
cdeprty:   decrypted, decrypt
cdfgino:   confiding
cdfilor:   clifford
cdfiltu:   difficult
cdghilo:   godchild
cdghint:   ditching
cdgikno:   docking
cdgiknu:   ducking
cdgilno:   condoling, colliding, codling, coddling
cdgilnu:   including, cuddling
cdgimno:   incommoding
cdginor:   corroding, cordoning, cording
cdginot:   conditioning
cdginou:   conducing
cdgintu:   inducting
cdhipty:   diptych
cdhkouw:   woodchuck
cdhlopy:   copyhold
cdhmoru:   murdoch
cdhnort:   notochord
cdiloty:   docility
cdilotz:   colditz
cdilouy:   cloudily
cdiltuy:   lucidity, ductility
cdimnou:   condominium
cdimoru:   corodium
cdimoty:   commodity
cdinotu:   induction, conduit, conduction
cdiotuv:   oviduct
cdiptuy:   pudicity, cupidity
cdirtuy:   crudity
cdmnopu:   compound
cdmnoru:   corundum, conundrum
cdnortu:   conductor
cdnotuw:   countdown
cdoprtu:   product
cefgiln:   fleecing
cefginr:   referencing
cefgint:   infecting, effecting
cefglnu:   effulgence
cefhikr:   kerchief
cefhily:   chiefly
cefhitw:   fitchew
cefhlrt:   fletcher
cefhlru:   cheerful
cefhmnr:   frenchmen
cefiklr:   flicker, fickler
cefilnt:   inflect
cefilnu:   influence
cefilru:   lucifer
cefilry:   fiercely
cefilty:   felicity
cefimnu:   munificence
cefimor:   comfier
cefinor:   reinforce, conifer
cefinot:   infection, confetti, confection, confectio, coefficient
cefinrt:   interference, frenetic
cefintv:   ineffective
cefioru:   coiffure, coiffeur
cefirty:   rectify, certify
cefklor:   rockefeller, forelock
cefklot:   fetlock
cefkorw:   workforce
ceflnor:   florence
ceflnou:   flounce, confluence
ceflnuy:   fluency
ceflort:   reflector
cefloru:   forceful
cefmnor:   conformer
cefmort:   comforter
cefnotu:   confute
cefnrvy:   fervency
cefoprt:   perfecto
cefortu:   forecourt
ceforty:   refectory
cefprtu:   prefecture
ceghikn:   chickening, checking
ceghiln:   leeching, clenching
ceghino:   echoing
ceghinp:   cheeping
ceghinr:   enriching, cheering
ceghint:   etching
ceghinw:   chewing
ceghiny:   hygienic
ceghoru:   churchgoer
cegijnt:   injecting, ejecting
cegiknp:   pecking
cegiknr:   recking
cegiknt:   ticketing
cegilno:   oligocene
cegilnp:   penciling
cegilnr:   reclining, encircling
cegilnt:   neglecting, intelligence, eliciting, electing
cegilnu:   clueing
cegilnx:   excelling
cegimno:   commencing
cegimnt:   cementing
ceginor:   encoring, cornering, concierge, concerning, coercing
ceginot:   contingent, contingence, contenting, connecting
ceginov:   inconveniencing, convening, conceiving
ceginoz:   cozening, cognizee
ceginpr:   piercing, creeping
ceginpt:   incepting, epigenetic
ceginrt:   reciting, erecting, energetic, centering
ceginru:   recurring
ceginrv:   reverencing, receiving
ceginrw:   crewing
cegintv:   evicting
cegintx:   exciting
ceginxy:   exigency
ceglnoy:   gynecology, glycogen
ceglnrt:   neglecter
ceglory:   glycerol
cegmnry:   emergency
cegnort:   concertgoer
cegnoru:   congruence
cegnorv:   convergence, converge
cegnory:   cryogen
cegnpuy:   pungency
cegnruy:   urgency
cehijor:   jericho
cehikly:   cheekily
cehiknt:   thicken, kitchenette, kitchen
cehikrt:   thicker
cehilmn:   michelin
cehilmt:   mitchell
cehilno:   helicon
cehilnr:   clincher
cehilnt:   lecithin
cehilor:   choleric
cehilot:   eolithic
cehilru:   richelieu
cehilrv:   chervil
cehilry:   cheerily
cehimny:   chimney
cehimor:   homeric
cehimpt:   mephitic
cehimrt:   hermetic
cehimru:   chummier
cehinor:   incoherence, chorine
cehinpr:   pincher, encipher
cehinru:   crunchier
cehinty:   ethnicity
cehiopr:   choppier
cehiort:   theoretic, ricochet, rhetoric
cehiotv:   cheviot
cehiprt:   pitcher
cehipty:   epiphytic
cehirvw:   whichever
cehklmo:   hemlock
cehkmor:   checkroom
cehkorv:   overcheck
cehkory:   chokecherry
cehkotu:   checkout
cehkptu:   ketchup
cehlmor:   cromlech
cehlnou:   luncheon
cehlopt:   photocell
cehlort:   chortle
cehmnor:   monochrome
cehmnrt:   trenchermen, retrenchment, entrenchment
cehmnru:   churchmen
cehmort:   hectometer
cehnopu:   puncheon
cehnort:   coherent
cehnorv:   chevron
cehnory:   coherency
cehnpru:   puncher
cehnqru:   quencher
cehntuy:   chutney
cehoprt:   photoreceptor
cehopry:   prophecy
cehoqru:   eurocheque
cehortu:   retouch
cehorty:   erythrocyte, crotchety
cehoruv:   voucher
cehqrux:   exchequer
ceijnot:   injection, ejectione, ejection
ceijnrt:   interject
ceiklmr:   limerick
ceiklnr:   crinkle, clinker
ceiklnt:   telekinetic
ceiklor:   rocklike
ceiklpr:   pricklier, prickle, pickerel
ceiklrt:   trickle, tickler
ceiklru:   luckier
ceiknot:   nektonic
ceiknpr:   picnicker
ceiknqu:   quicken
ceikopt:   pickpocket
ceikorw:   wickerwork
ceikqru:   quicker
ceikrty:   trickery, rickety
ceilmnr:   criminelle
ceilmnt:   inclement, clementine
ceilmny:   inclemency
ceilmop:   polemic, complice, compile
ceilmor:   comelier
ceilmrt:   telemetric
ceilmrv:   vermicelli
ceilmuy:   mycelium
ceilnop:   pliocene
ceilnor:   reconcile, crinoline
ceilnot:   election, collection
ceilnou:   nucleonic, nucleoli
ceilnov:   violoncello, violence
ceilnox:   lexicon
ceilnoz:   colonize
ceilnpr:   principle, princelier
ceilnrt:   centiliter
ceilnuy:   unicycle
ceiloqu:   coquille
ceilort:   elicitor
ceilory:   colliery
ceilorz:   colorize
ceilotv:   collective
ceilpru:   periculi
ceilptx:   explicit
ceilquy:   cliquey
ceilrtu:   reticule
ceilrtv:   civiliter
ceilrty:   tricycle, electricity, celerity
ceimnot:   committeemen, commitment, centimo
ceimnou:   uneconomic, encomium
ceimnoy:   neomycin
ceimnoz:   economize
ceimnpt:   impenitence
ceimnrt:   intermittence, increment, centimeter
ceimnru:   numeric
ceimntx:   excitement
ceimort:   recommit, micrometer, meteoritic, meteoric
ceimotx:   toxemic
ceimrtu:   turmeric
ceimtvz:   victimize
ceinopr:   porcine
ceinopt:   inception, conception
ceinort:   reconnoiter, necrotic, interconnection, interconnect, incorrect, erection, criterion, correction, contrite, concretion, concertino, concerti, concentric, citroen
ceinorv:   corvine, conniver, conceiver
ceinorx:   exocrine
ceinotu:   teutonic, continue, connecticut
ceinotv:   inconvenient, eviction, convention, convenient, convection, connective
ceinotx:   extinction
ceinprt:   recipient, precipitin, precinct, pertinence, percipient, intercept, epicenter, centerpiece
ceinpru:   prurience
ceinprx:   inexperience, experience
ceinpry:   percipiency
ceinptv:   inceptive
ceinrtu:   tincture, cincture
ceinrty:   intercity, eccentricity
ceioprt:   receiptor, coopertio
ceiopru:   occupier, croupier
ceioprv:   overprice
ceioptz:   poeticize, epizootic
ceiortu:   couturier, courtier
ceiortv:   evictor, corrective
ceioruz:   cruzeiro
ceiorvy:   viceroy
ceiprtu:   picture
ceiprtv:   receptive, perceptive
ceiprty:   pyretic
ceiqrtu:   critique
ceirtux:   executrix
ceituvx:   executive
cejnoru:   conjurer, conjure
cejnrtu:   juncture
cejoprt:   projector, project
ceklorw:   rockwell
ceklrtu:   truckle
cekmory:   mockery
cekntuy:   kentucky
cekorty:   rocketry
celmopt:   complete
celmopx:   complex
celmort:   electrometer
celmpru:   crumple
celnopu:   uncouple, opulence
celnoqu:   eloquence
celnort:   electron, controller
celnpru:   purulence
celnrtu:   truculent, truculence
celnrty:   recently
celntxy:   excellently
celopru:   coupler
celoptu:   couplet
celortu:   electrocute, cloture
celortv:   coverlet
celorty:   electrolyte, correctly
celrtuv:   culvert
celrtuy:   cutlery, cruelty
cemnopt:   contempt, component, competent, competence
cemnort:   contemner
cemnorw:   newcomer
cemnory:   ceremony
cemnoyz:   coenzyme
cemnrtx:   excrement
cemoptu:   computet, compute
cemortu:   commuter
cemprtu:   crumpet
cenopru:   pronounce
cenoprv:   provence
cenopty:   potency
cenoqru:   conqueror, conquer
cenortu:   trounce, rencounter, recount, nonconcurrent, nocturne, encounter, countertenor, counter, concurrent
cenortv:   reconvert, convertor, converter, convert, convector, controvert
cenoruv:   uncover
cenoruy:   eurocurrency
cenorvy:   conveyor, conveyer
cenprtu:   puncture
cenprty:   encrypt
cenrtuy:   century
ceoprtu:   corrupter
ceopruy:   reoccupy, preoccupy
ceoqrtu:   croquette, croquet
ceortuv:   coverture
ceortux:   executor
ceortxy:   excretory
cfghiln:   flinching, filching
cfgikln:   flicking
cfgiknu:   fucking
cfgilnt:   inflicting
cfginor:   forcing
cfginty:   citifying
cfhinor:   honorific
cfhklou:   chockfull
cfhlmor:   chloroform
cfiklnu:   cufflink
cfilmor:   microfilm
cfilnot:   infliction, conflict, clifton
cfilopr:   prolific
cfimnor:   confirmor, confirm
cfimoru:   cruciform
cfinort:   friction
cfinotu:   function
cfirtuy:   fructify
cfknoru:   unfrock
cfloruy:   colorfully
cghikno:   hocking, choking
cghiknu:   chunking, chucking
cghilnu:   lunching
cghilny:   lynching, chillingly
cghimno:   mooching
cghimnu:   munching, chumming
cghinop:   chopping
cghinot:   notching
cghinou:   hiccoughing, coughing, couching
cghinpr:   chirping
cghinpt:   pitching
cghinpu:   punching, hiccupping, hiccuping
cghinru:   crunching, churning
cghintu:   unhitching
cghintw:   witching, twitching
cghinvy:   chivying, chivvying
cghoruy:   grouchy
cgijnou:   jouncing
cgiklno:   locking, clocking
cgiklnp:   pickling
cgiklnr:   crinkling
cgiklnt:   tickling
cgiklnu:   knuckling, clucking
cgikmno:   mocking
cgikmnu:   mucking
cgikmry:   gimmickry
cgiknor:   rocking, crooking, crocking, corking
cgiknou:   cuckooing
cgiknov:   convoking
cgiknpr:   pricking
cgiknpt:   nitpicking
cgiknpu:   unpicking
cgiknrt:   tricking
cgiknru:   rucking
cgikntu:   tucking
cgilmno:   commingling
cgilmny:   mincingly
cgilnop:   policing, clopping
cgilnor:   coloring
cgilnot:   clotting
cgilnou:   uncoiling, unclogging
cgilnow:   cowling, clowning
cgilnoy:   cloying
cgilnoz:   colonizing
cgilnpr:   crippling
cgilnpu:   unclipping
cgilnru:   uncurling, curling
cgilnuy:   cunningly
cgilnvz:   civilizing
cgilopt:   topologic
cgilorw:   cowgirl
cgilrtu:   liturgic
cgimnot:   commoting, committing
cgimnou:   communing
cgimnox:   commixing
cgimnpr:   crimping
cginopr:   cropping
cginopu:   pouncing
cginopy:   copying
cginort:   contorting
cginoru:   occurring, concurring
cginorw:   crowning, crowing
cginotu:   counting, continuing
cginotv:   convicting, cognovit
cginouv:   unconvincing
cginovy:   convoying
cginrtu:   circuiting
cginrtz:   criticizing
cginruv:   curving
cginruy:   currying
cgiotyz:   zygotic
cgklnou:   gunlock
cgnortu:   goncourt
chiklty:   thickly
chikopt:   toothpick
chikory:   hickory
chilmou:   colchicum
chilnot:   octillionth, loincloth
chimnop:   monophonic, homophonic
chimnor:   monochromic
chimnoy:   homonymic
chimopr:   microchip
chimoru:   chromium
chimrty:   rhythmic
chinort:   orthicon, corinth
chintyz:   chintzy
chiprty:   triptych
chlopry:   chlorophyll, chlorophyl
chlopty:   polyptych
chmnotu:   cottonmouth
cijnotu:   junction, injunction, conjunction
ciklnuy:   unluckily
ciklopt:   politick
ciklpry:   prickly
ciklpuy:   pluckily
ciklquy:   quickly
ciklrty:   trickily
cilmnot:   locomotion
cilmopt:   impolitic, complicit
cilmopy:   olympic
cilmoqu:   colloquium
cilmpty:   implicitly
cilnopy:   polyclinic
cilnoru:   councilor
cilnotu:   locution, illocution
cilnouv:   vinculo
cilntvy:   incivility
cilnuvy:   uncivilly
cilopry:   pyloric
cilortv:   vitriolic
cilprtu:   culprit
cimnoqu:   communiqu
cimnotu:   continuum, comminution
cimnpru:   principium
cimortu:   microcircuit, committitur
cinortu:   ruction
cinotuy:   continuity
cioprty:   prototypic, cypriot
cioqtux:   quixotic
ciortvy:   victory
ckloptu:   potluck
clmnouy:   uncommonly
clnorty:   cyclotron
clortuy:   courtly
cmortuw:   cutworm
cnortuy:   country
defgiln:   fledgling, fledging, fledgeling, fielding, defiling
defgilr:   filigreed
defgino:   offending
defginr:   redefining, infringed, fringed, fingered, differing, deferring
defgint:   fidgeting
defginu:   unfeigned, undignified, feuding
defginy:   edifying, deifying, defying
defgior:   firedog
defgiru:   figured
defgity:   fidgety
defglnu:   unfledged, engulfed
defgluw:   gulfweed
defgory:   godfrey
defhilo:   lifehold
defhimu:   humidified, dehumidified
defhior:   horrified
defhlor:   freeholder, freehold
defhlrw:   freewheeled
defhluy:   heedfully
defhort:   frothed
defhrtu:   furthered
defilmn:   minefield, fieldmen
defilmo:   mollified
defilmr:   midfielder
defilno:   ninefold
defilnr:   infielder, friendlier
defilnu:   unfulfilled, unfilled, undefiled, nullified
defilov:   fivefold
defilpr:   pilfered
defilqu:   liquefied
defilrt:   trifled, flirted, filtered
defilru:   flurried, direful
defilrw:   wildfire
defilrz:   frizzled
defilty:   fidelity, fetidly
defilxy:   fixedly
defimny:   indemnify
defimor:   modifier
definot:   notified, definition
definpr:   predefined, predefine
definrt:   nitrified, interfered, indifferent, identifier, different, denitrified
definru:   unrefined, unfired, reunified
definrz:   frenzied
defintu:   unidentified, unfitted, infinitude
defintv:   definitive
definty:   identify
definux:   unfixed
defiopr:   fireproofed
defiort:   retrofitted, fortified, forfeited
defiorw:   firewood
defiotu:   outfitted
defiotx:   toxified, detoxified
defiprt:   prettified, petrified
defipru:   purified
defiprv:   perfervid
defiprx:   prefixed
defipry:   perfidy
defipty:   typified
defirtu:   fruited
defirtv:   vitrified
defklnu:   flunked
deflnot:   tenfold
deflnou:   unfolded
deflnru:   unruffled, unfurled
deflort:   foretold
defloru:   floured
deflorw:   flowered, deflowered, deflower
deflotu:   flouted
deflotw:   fleetwood
deflouy:   dolefully
deflrtu:   fluttered
defmnot:   fomented
defmnou:   dumfounded
defmnrt:   fermented, deferment
defmnru:   referendum
defmopr:   performed
defmpru:   perfumed
defnort:   tenderfoot, fronted
defnoru:   foundered, founder
defnorw:   frowned
defnrtu:   unfettered
deforuw:   furrowed
defotux:   outfoxed
deghilt:   lighted, highlighted, delighted, delight
deghinr:   hindering, herding
deghint:   tightened, heightened
deghinu:   unhinged, unheeding
deghinv:   inveighed
deghirt:   righted
deghitw:   weighted
deghlnt:   lengthened
deghnru:   hungered
deghoru:   roughed
deghorw:   hedgerow
degijln:   jingled
degikln:   enkindling
degiklo:   godlike
degilmn:   mingled, melding, meddling
degilmr:   glimmered
degilnp:   pledging, peddling
degilnr:   ridgeling, lingered
degilnt:   tingled, glinted, diligent, deleting
degilnu:   indulged, indulge, guideline, eluding, dueling, deluging, deluding
degilnv:   inveigled, deviling, delving
degilnw:   wielding, welding, indwelling, dwelling
degilny:   yieldingly, yielding
degilor:   gloried
degilou:   ideologue
degiloy:   ideology
degilrt:   glittered
degilru:   guilder
degilrw:   wriggled, wergild
degilry:   greedily
degilrz:   grizzled
degiluv:   divulged, divulge
degimnp:   impinged, impending, impeding
degimnr:   reminding, redeeming
deginor:   reordering, ordering, negroid, ignored, eroding, doddering
deginot:   denoting
deginow:   widgeon, endowing
deginpu:   upending
deginpx:   expending
deginrt:   trending, tendering, reediting, ingredient, deterring
deginru:   enduring
deginrv:   diverging, deriving
deginrw:   rewinding, redwing
deginrz:   energized
degintx:   extending
deginux:   exuding
degiopr:   porridge
degipru:   pudgier
degirtz:   digitizer
degjpru:   prejudged, prejudge
degklnt:   kentledge
deglmno:   monologged
deglnou:   lounged
deglnpu:   unplugged, plunged
deglopr:   pledgor
deglorv:   groveled
deglorw:   growled, glowered
deglruy:   ruggedly
degmpru:   grumped
degnopr:   pronged
degnoru:   ungrounded, underground, undergone, undergo, underdog, reground, grounder, grounded
degnorv:   governed
degnorw:   wronged, wrongdoer
degnotu:   tongued, outgunned
degnpux:   expunged
degnrtu:   grunted
degopru:   regrouped, prorogued, grouped
degortu:   grouted
dehiklo:   likelihood
dehilop:   pedophile
dehilot:   theodolite
dehilov:   livelihood
dehilrt:   thrilled
dehilrw:   whirled
dehiltw:   withheld, whittled
dehilty:   diethyl
dehimnu:   inhumed
dehimor:   hemorrhoid, heirdom
dehimrt:   meredith
dehinpr:   ephedrine
dehinrt:   inherited
dehinru:   unhurried, unhindered
dehintw:   whitened
dehiorw:   widowerhood
dehiotu:   hideout
dehirtv:   thrived
dehirtw:   writhed, withered, withdrew
dehirty:   heredity
dehknou:   unhooked
dehknru:   hunkered
dehlort:   throttled
dehlrtu:   hurtled
dehmnoy:   honeymooned
dehmort:   motherhood, mothered
dehmoru:   humored
dehmotu:   mouthed
dehmptu:   thumped
dehmrtu:   thrummed
dehnort:   enthroned, dethroned, dethrone
dehnoru:   hundredor, horehound
dehnowy:   honeydew
dehnrtu:   untethered, thundered, thunder, thereunder, hundredth
dehnruw:   whereunder
dehortx:   heterodox, exhorted
deijnor:   rejoined, rejoinder, joinder, enjoinder
deijnot:   jointed
deijnru:   uninjured, injured
deijory:   joyride
deiklmw:   milkweed
deiklnr:   rekindled, rekindle, kindlier, kilderkin
deiklnt:   tinkled
deiklnu:   unlinked
deiklnw:   winkled
deiknov:   invoked
deiknrt:   tinkered
deikqru:   quirked
deilmnu:   illumined
deilmop:   imploded, implode
deilmor:   moldier
deilmot:   dolomite
deilmoy:   myeloid
deilmpr:   imperiled
deilmrt:   delimiter
deilmru:   delirium
deilmtu:   multitude
deilnot:   indolent, deletion
deilnov:   involved
deilnoz:   lionized
deilnrt:   tendril, interlined
deilnru:   underlined, underline, underlie
deilntu:   untitled, unentitled, undiluted
deilnuv:   unveiled
deilnvy:   divinely
deilopr:   pilloried
deilopt:   piloted
deilopw:   woodpile
deilort:   loitered
deilorv:   evildoer
deilorw:   worldwide, worldlier
deilprt:   tripled
deilprv:   replevied
deilqtu:   quilted
deilquz:   liquidized, liquidize
deilrtu:   telluride
deilrtw:   twirled
deilrty:   tiredly
deilrvy:   redelivery, delivery
deilrwy:   weirdly
deiltuy:   yuletide
deiltuz:   utilized
deimnor:   domineered, domineer
deimnot:   motioned, mentioned, demotion
deimnou:   idoneum, diminuendo
deimnox:   monoxide
deimnoz:   demonized, demonize
deimnpt:   pediment, impediment
deimnpu:   unimpeded
deimnrt:   redetermined, redetermine, intermitted, dinnertime, detriment, determiner, determined, determine
deimnru:   undermined, undermine
deimntu:   untimed, mutinied, minuted, indument
deimnty:   indemnity
deimnux:   unmixed
deimnuz:   immunized
deimort:   meteoroid
deimorz:   memorized
deimotv:   vomited
deimprt:   pretermited, permitted
deimpru:   umpired, dumpier
deimprx:   premixed
deimptu:   imputed
deimrtu:   deuterium
deinopr:   pioneered
deinopt:   pointed, pinpointed, petitioned, endpoint
deinort:   reoriented, rendition, oriented, indentor
deinorv:   overridden, overdriven
deinorw:   eiderdown, downier
deinotv:   vendition, devotion
deinouz:   unionized
deinpqu:   unequipped
deinprt:   reprinted, reinterpreted, printed, intrepid, interpreted, interdependent
deinpru:   underpinned, underpin
deinpry:   pyridine
deinptu:   inputted, ineptitude
deinptx:   inexpedient, expedient
deinpuz:   unzipped
deinqru:   inquired
deinqtu:   quietened
deinrtu:   untried, untidier, reunited, intruder, intruded, intrude, indentured, indenture
deinrtv:   reinvented, inverted, intervened
deinrtw:   wintered, intertwined
deinrtx:   dextrin
deinrtz:   tenderizer, tenderized, tenderize
deinruw:   unwired
deintuv:   uninvited
deintuz:   unitized
deioprt:   propertied
deioprv:   provider, provided, provide
deioprw:   piepowder
deioprx:   peroxide
deioptv:   pivoted
deioptz:   poetized
deiortu:   outrider
deiortx:   trioxide
deiortz:   terrorized
deiorxz:   oxidizer
deiotuw:   outwitted
deiprtu:   turpitude, irrupted
deiprtx:   expediter
deiprvw:   previewed
deiptuz:   deputized, deputize
deiqrtu:   requited
deiqruv:   quivered
deirtxy:   dexterity
dejkntu:   junketed
dejorvy:   overjoyed
deklnpu:   plunked
deklnru:   knurled
deklorv:   overlooked
deknoty:   keynoted
deknouy:   unyoked
dekoprv:   provoked
dekorvw:   overworked
dekorwy:   keyword
delmnpu:   pendulum
delmntu:   unmelted
delmopy:   employed
delmpru:   rumpled
delmptu:   plummeted
delmruy:   demurely
delnopu:   unpooled
delnopv:   enveloped
delnort:   redolent
delnoru:   unrolled, roundel
delnotw:   letdown
delnouv:   unloved
delnowy:   woodenly
delnpru:   plunderer, plundered, plunder
delnpty:   dependently
delnrtu:   unlettered, underlet, trundled, trundle
delnrty:   tenderly
deloprt:   droplet
deloprv:   redeveloped, redevelop, overdeveloped, overdevelop, developer
deloprw:   prowled
deloprx:   explored
delopry:   redeployed, redeploy
deloptu:   polluted
delortv:   revolted
deloruv:   overruled, overloud, louvered
delotvy:   devotedly
demnort:   tormented, mordent
demnoru:   mourned
demnotu:   mounted, denouement
demnotw:   endowment, dowment
demnouv:   unmoved
demoprt:   tromped, prompted, promoted, pedometer
demoprw:   empowered
demprtu:   trumpeted, trumped, permuted
denoprt:   portended, portend
denopru:   propounded, pounder
denoprv:   provender
denopux:   expounded, expound
denoqtu:   unquoted
denortu:   untutored, undertone, undernoted, deuteron
denortw:   downtrodden, downtrend
denoruw:   undowered, rewound
denotuw:   unwonted
denprtu:   upturned, uptrend, prudent
denprtv:   prevented
denrtuv:   ventured
denrtuw:   underwent
deoprtu:   uprooted, trouped, purported, protruded, protrude, outpoured
deoprtx:   exported
deoprvw:   overpowered
deoprwy:   powdery
deortvx:   overexerted, extroverted
depruvy:   purveyed
dfgilno:   fondling, folding, flooding
dfgilnu:   fuddling
dfginor:   fording
dfginou:   fungoid, founding
dfginrt:   drifting
dfginry:   rigidifying
dfgirty:   frigidity
dfhimuy:   humidify
dfhlopt:   photoflood
dfhnoux:   foxhound
dfilmnu:   unmindful, mindful
dfiltuy:   fluidity, dutifully
dfiortw:   driftwood
dfnopru:   profound
dfnoruy:   foundry
dghikno:   hodgkin
dghilno:   holding
dghilnu:   huddling, dunghill
dghilor:   girlhood
dghimnt:   midnight
dghinot:   goodnight
dghinou:   hounding
dghintu:   thudding
dghlory:   hydrology
dghnoru:   groundhog
dghnotu:   doughnut
dghortu:   drought
dghotuy:   doughty
dgikmno:   kingdom
dgilmno:   mongoloid, molding
dgilmnp:   dimpling
dgilmnu:   muddling
dgilnop:   plodding
dgilnor:   lording, drooling
dgilnot:   toddling
dgilnoz:   idolizing
dgilnrz:   drizzling
dgilntu:   diluting
dgilntw:   twiddling
dgilnuv:   divulging
dgilnuy:   undyingly
dgilnyz:   dizzyingly
dgilory:   iridology
dgimnor:   midmorning
dgimnou:   mounding
dgimnpu:   dumping
dgimnru:   drumming
dgimnuy:   muddying
dginopr:   prodding, dropping, drooping
dginopu:   pounding
dginort:   dogtrotting
dginoru:   rounding, grounding
dginorw:   wrongdoing, wording, drowning
dginotu:   outdoing
dginouw:   wounding
dginoxz:   oxidizing
dginrtu:   trudging, intruding
dginrty:   dirtying
dgiopry:   prodigy
dgirtuy:   turgidity
dglnouy:   ungodly
dgmopru:   gumdrop
dgnortu:   groundnut
dhiknow:   hoodwink
dhilnop:   dolphin
dhilnow:   downhill
dhilnrw:   whirlwind
dhilory:   horridly
dhilotw:   withhold
dhilrty:   thirdly
dhimopr:   dimorph
dhimoru:   rhodium, humidor
dhimtuy:   humidity
dhiopty:   typhoid
dhiorty:   thyroid
dhjopru:   jodhpur
dhlmotu:   loudmouth
dhlorxy:   hydroxyl
dhortxy:   orthodoxy
diklnuy:   unkindly
dilmnop:   millpond
dilmnru:   drumlin
dilmpty:   limpidity
dilnotu:   dilution
dilntuy:   untidily
dilopry:   droopily
dilorty:   torridly
dilorwy:   wordily, rowdily
dilqtuy:   liquidity, illiquidity
dimnopt:   midpoint
dimnopu:   impound
dimnory:   myrmidon
dimnotu:   diminution
dimnotw:   midtown
dimorty:   dormitory
diprtuy:   putridity
dlnoruy:   roundly
dlopruy:   proudly
dmnortu:   dortmund
dmnoruw:   roundworm
dnopruw:   downpour
dnortuw:   turndown, downturn
efghint:   hefting
efghirt:   freighter, freight, fighter
efgilno:   lifelong
efgilnr:   refilling, fingerling
efgilnt:   fleeting, filleting, fettling, felting
efgilnu:   unfeeling, funneling, fueling, engulfing
efgilnx:   flexing
efgilny:   feelingly
efgiluy:   guilefully
efgimnt:   figment
efginor:   offering, foreigner, foreign, foregoing, forefinger
efginpr:   preferring
efginrt:   refitting, interfering, frittering, fretting, fettering, ferreting
efginru:   gunfire, figurine
efginry:   reifying, refrying, ferrying
efginrz:   freezing
efgiopt:   pettifog
efgiorv:   forgive
efgipru:   prefigure
efgituv:   fugitive
efgknru:   fenugreek
efglnry:   greenfly
efglntu:   effulgent
efglnuv:   vengeful
efglovx:   foxglove
efglrtu:   regretful
efgmnor:   frogmen
efgnort:   forgotten
efhilrt:   filthier
efhiort:   frothier, fortieth
efhlnpu:   unhelpful
efhlopu:   hopeful
efhlpuy:   helpfully
efhmort:   thermoform, therefrom
efijlot:   jetfoil
efiknru:   funkier
efikorw:   firework
efilmnr:   riflemen
efilmot:   leitmotif
efilmtx:   flextime
efilmuv:   effluvium
efilnox:   flexion
efilnrt:   infertile, flintier
efilnru:   nullifier
efilntu:   influent
efilnty:   infinitely, finitely
efilopr:   profiler, profile, floppier
efilort:   trefoil, loftier
efilorv:   overfill
efilorw:   flowerier
efilquy:   liquefy
efilrty:   fertility
efilrtz:   fertilizer, fertilize
efilruy:   irefully
efilrvx:   reflexive
efiltuy:   futilely
efimnor:   informer
efimnrt:   refinement
efimnty:   femininity
efimorv:   vermiform
efimpru:   frumpier
efinort:   interferon, frontier
efinrtu:   furniture
efinruy:   reunify
efioprt:   profiteer
efioprw:   firepower
efiortu:   outfitter, forfeiture
efiorwz:   frowzier
efiprty:   prettify, petrify
efirtuv:   furtive
efirtux:   fixture
efklmno:   menfolk
efknort:   foretoken
efkortw:   fretwork
eflmory:   formerly
eflmruy:   flummery
eflntuv:   uneventful, eventful
eflntuy:   tunefully, fluently
eflortv:   leftover
eflortx:   retroflex
eflorvw:   overflow, overflew
eflorvy:   overfly
eflorwy:   flowery
eflouwy:   woefully
eflrtuy:   fretfully, fluttery
efmnort:   fremont, fomenter
efmnorw:   forewomen
efmnprt:   preferment
efmpruy:   perfumery
efnoprv:   ovenproof
efnortu:   fourteen, fortune
efnortw:   freetown, forwent, forewent
efnorty:   effrontery
efnoruz:   unfrozen, unfroze
efnqrtu:   frequenter, frequent
efoprty:   ferrotype
efoqrtu:   roquefort
efprtuy:   putrefy
eghiknr:   gherkin
eghilmt:   limelight
eghilno:   helloing
eghilnp:   helping
eghilnr:   hireling
eghilnt:   lightening, lighten, lengthening, enlightening, enlighten
eghilnw:   wheeling
eghilrt:   lighter, highlighter
eghiltw:   lightweight
eghimnu:   guggenheim
eghimrt:   mightier
eghinpy:   hyphening
eghinrt:   tethering, inheriting
eghinru:   hungrier, hungering
eghintv:   thieving
eghintw:   whitening, whetting, weighting
eghinwz:   wheezing
eghiotu:   toughie
eghiotz:   ghettoize
eghirtw:   weightier
eghitwy:   weighty
eghlmou:   homologue
eghlmpy:   phlegmy
eghlnty:   lengthy
eghloty:   theology
eghmnoy:   hegemony
eghnoru:   roughen
eghnotu:   toughen, huguenot
eghortu:   tougher, rethought
egijknr:   jerking
egijlny:   jellying
egijnor:   rejoining
egijnoy:   enjoying
egiklnt:   kinglet
egiknov:   evoking
egiknpr:   perking
egiknrt:   trekking, tinkering
egilmnp:   impelling
egilmnr:   gremlin, glimmering
egilmnt:   melting
egilmnw:   mewling
egilmor:   gloomier
egilmot:   legitimo
egilmpu:   plegium
egilmtz:   legitimize
egilnop:   peopling, eloping
egilnor:   religion, enrolling
egilnov:   livelong, evolving
egilnow:   lilongwe
egilnpr:   repelling, periling
egilnpt:   pelting
egilnpx:   expelling
egilnpy:   yelping
egilnqu:   quelling
egilnrt:   ringlet, retelling, relenting, littering, lettering, interlining, glittering
egilnru:   unreeling, grueling
egilnrv:   reviling, reveling, reliving, relieving, levering, inveigler
egilnry:   relying, lingeringly, gingerly
egilntu:   unintelligent, tunneling, eluting
egilntw:   welting
egilntx:   telexing
egilnty:   tellingly, negligently, intelligently, gentility
egilnuv:   unveiling
egilnuy:   genuinely
egilnvy:   levying
egilopu:   epilogue
egiloty:   etiology
egilouz:   eulogize
egilprv:   privilege
egilrtu:   guiltier
egilrty:   glittery
egilruv:   virgule
egilrwy:   wrigley
egimnor:   mongering
egimnot:   mignonette, mentioning, emoting
egimnov:   envenoming
egimnow:   meowing
egimnpr:   premiering, perming
egimnpt:   tempting, pigment, impingement
egimnrt:   terming, remitting, regimenting, regiment, mitering, metering, meriting, intermitting
egimnru:   meringue
egimntu:   integument, gentium
egimntz:   itemizing
egimopt:   impetigo
egimorv:   moviegoer
egimpru:   grumpier
eginopr:   reopening, porringer, pioneering, peignoir
eginopt:   tiptoeing, petitioning
eginort:   tottering, retorting, reorienting, orienting, orienteering, nitrogen, interrogee, genitor
eginorv:   governing
eginorx:   xeroxing
eginorz:   zeroing, rezoning
eginotv:   vetoing
eginpqu:   equipping
eginprt:   reprinting, repenting, reinterpreting, petering, interpreting
eginpru:   pureeing
eginprv:   reprieving
eginprx:   expiring
eginpry:   preying
eginptz:   peptizing
eginpux:   expunging
eginqru:   requiring, queering
eginqtu:   quieting, quietening
eginrtu:   uttering, unigeniture, reuniting, returning, neutering, intrigue, guttering, guertin
eginrtv:   riveting, reverting, retrieving, reinventing, inverting, intervening
eginrtw:   wintering, wintergreen, twittering, rewriting, intertwining
eginrtx:   exerting
eginrty:   retying, retrying, integrity
eginruv:   unnerving
eginrvw:   reviewing
egintuy:   ingenuity
egintwz:   tweezing
egiopru:   pirogue, groupie
egiortu:   outrigger
egiortv:   vertigo
egklorw:   legwork
eglmnor:   mongrel
eglmnou:   monologue
eglmoty:   etymology
eglnopy:   penology
eglnort:   lorgnette
eglnoru:   lounger
eglnorv:   overlong
eglnpru:   plunger
eglopru:   prologue
eglopty:   logotype, egyptology
egmnort:   montenegro, engorgement
egmnoru:   rumormonger
egmortu:   gourmet
egmorty:   geometry
egnopry:   progeny
egnopty:   genotype
egnortw:   georgetown
egnoruy:   younger
egnorvw:   overgrown
egortuw:   outgrew
ehiklmo:   homelike
ehiknrt:   thinker, rethink
ehilmop:   homophile
ehilmor:   homelier, heirloom
ehilnop:   pinhole
ehilnot:   hotline
ehilnpw:   pinwheel
ehilort:   hotelier
ehilprt:   philter
ehilrtw:   whittler
ehiltwy:   whitely
ehimnru:   rhenium
ehimntv:   vietminh
ehimorz:   rhizome
ehimprw:   whimper
ehinopr:   phonier, hornpipe
ehinopx:   phoenix
ehinort:   thornier, inheritor
ehinprt:   trephine, nephrite
ehinrtv:   thriven
ehinrtw:   whitener
ehinrtx:   inheritrix
ehintwy:   whitney
ehiortw:   worthier
ehiortz:   theorizer, theorize
ehiotuw:   whiteout
ehirtvy:   thievery
ehklnot:   knothole
ehkmorw:   homework
ehlmnot:   menthol
ehlmnty:   methylene
ehlnopt:   telephone
ehlnowy:   honeywell
ehloprt:   porthole
ehmnopr:   pheromone
ehmnort:   enthronement
ehmnorw:   homeowner
ehmnory:   honeymooner
ehmnptu:   umpteenth
ehmnpty:   nymphet
ehmoprt:   photometer
ehmorty:   thermometry
ehmorvw:   whomever
ehnopru:   hereupon
ehnopty:   phenotype, neophyte
ehnopuy:   euphony
ehnortu:   thereunto, hereunto
ehoprty:   hypertrophy
ehoptyz:   zoophyte
ehortvw:   overthrow, overthrew
ehprtxy:   hypertext
eijklry:   jerkily
eijlnrt:   jetliner
eijlnuv:   juvenile
eijmpru:   jumpier
eijnort:   jointer
eijnory:   joinery
eijnpru:   juniper
eijprtu:   jupiter
eiklmno:   moonlike
eiklmnr:   kremlin
eiklnru:   unlikelier
eiklnrw:   wrinkle
eiklntu:   nutlike
eiklntw:   twinkle
eiklnuy:   unlikely
eiklorv:   overkill
eiklpry:   perkily
eikmnor:   moniker
eiknort:   knottier
eilmnot:   limonite, emollient
eilmnou:   linoleum
eilmnpr:   pimpernel
eilmnpt:   implement
eilmnry:   millinery
eilmnty:   imminently, eminently
eilmopr:   millipore, implore
eilmopt:   impolite
eilmort:   milometer
eilmotv:   leitmotiv
eilmpru:   plummier, lumpier
eilmptu:   multiple
eilmpty:   emptily
eilmrtu:   tellurium
eilmtuv:   multilevel
eilnopz:   pennzoil
eilnort:   ritornello, ritornelli
eilnorv:   overline
eilnotu:   outline, elution
eilnotv:   volenti, violent
eilnotw:   towline
eilnovz:   novelize
eilnprt:   teleprinter
eilnprv:   replevin
eilnpty:   penitently, ineptly
eilnpuv:   vulpine
eilnqru:   queenlier
eilnqtu:   quintile
eilnquy:   uniquely
eilnrty:   inertly, entirely
eilntvy:   inventively
eiloprt:   portlier, politer
eiloprv:   liverpool
eiloprw:   willpower
eiloptx:   exploit
eilopty:   politely
eilortu:   ulterior
eilortw:   rottweiler
eilorty:   toiletry
eilotuv:   outlive
eilprtx:   triplex
eilprty:   prettily
eilptvx:   expletive
eilqtuy:   quietly
eilrtuv:   rivulet
eilrtuz:   utilizer
eimnopt:   pimiento, pimento, omnipotent, impotent
eimnort:   termino
eimnorv:   omnivore
eimnotu:   mountie
eimnotz:   mezzotint
eimnprt:   peppermint, impertinent
eimnpru:   perineum
eimnptu:   pentium, neptunium
eimnrtu:   triennium, terminum, runtime, nutriment, mutineer, inurement
eimnrtw:   wintertime, intertwinement
eimnrtx:   intermix
eimnrtz:   intermezzi
eimoprt:   reimport, importer
eimopru:   europium, emporium
eimoprv:   improve
eimoptz:   optimize, epitomize
eimortv:   overtime
eimortz:   motorize
eimprtu:   repetitum, pretium
eimprtv:   primitive
eimrtux:   mixture
eimrtxy:   extremity
einoprt:   repetition, protein, pointer, petitioner
einoqtu:   quotient
einoqux:   equinox
einortu:   routine, neutrino
einortv:   reinvention, inventor, introvert, intervention, intervenor
einortx:   extortion, exertion
einorty:   notoriety
einprtu:   turpentine, prurient, interrupter, interrupt
einprtv:   preventive
einprtx:   inexpert
einptuv:   punitive
einqrtu:   quitrent
einqtuy:   inequity
einrtuv:   nutritive
einrtuw:   unwritten
einrtvw:   interviewer, interviewee, interview
einrtwy:   wintery
einrtwz:   winterize
eioprtu:   pirouette
eioprty:   propriety, petitory
eioprtz:   prioritize
eioqtux:   quixote
eiortvw:   overwrite
eiprtuv:   irruptive, eruptive
eiprtuy:   perpetuity
eiprtwy:   typewriter, typewrite
eipruvw:   purview
eiqruvy:   quivery
ejknrtu:   junketeer
ejmnoty:   enjoyment
ejmnruy:   jurymen
ejnoruy:   journey
ekmnorw:   workmen
ekmnptu:   unkempt
eknortw:   network
eknrtuy:   turnkey
elmnopt:   elopement
elmnort:   enrollment
elmnotu:   emolument
elmoprt:   teleprompter
elmopry:   polymer, employer
elmortv:   voltmeter
elmorty:   remotely
elmrtxy:   extremely
elnopry:   propylene, polypropylene
elnoptu:   opulent
elnopty:   potently
elnoqtu:   eloquent
elnorty:   rottenly
elnotuv:   volunte
elnotvy:   novelty
elnouvy:   unlovely
elnprtu:   purulent
elnrtvy:   reverently
eloprtu:   polluter
elopruv:   pullover
elortvy:   overtly
elprtxy:   expertly
emnortu:   remount
emnortv:   vermont
emnorty:   monterey
emoprtx:   extempore
emoprty:   pyrometer, peremptory, optometry
emprtuy:   trumpery
enoprtu:   opportune
enoprtw:   newport
enoprty:   entropy
enopruv:   unproven
enortuv:   turnover, overturn
enortuy:   tourney
eoprtvy:   poverty
eoprtwy:   typewrote
eopruvy:   purveyor
fghilot:   footlight
fghilty:   flighty
fghinot:   hotfooting
fghintu:   gunfight
fghiort:   forthright
fghiotu:   outfight
fghloru:   furlough
fghlotu:   thoughtful
fgiklnu:   flunking
fgiknor:   forking
fgilmnu:   muffling
fgilnop:   flopping
fgilnor:   flooring
fgilnot:   lofting, footling
fgilnou:   fouling
fgilnow:   wolfing, fowling, following, flowing
fgilnrt:   trifling, flirting
fgilnru:   unfurling, ruffling, furling
fgilnrz:   frizzling
fgilntu:   gunflint, fluting
fgilnty:   fittingly
fgilnux:   fluxing
fgilnuy:   nullifying
fgilnvy:   vilifying
fgilory:   glorify
fgimnor:   informing, forming
fgimnuy:   mummifying
fginopr:   proofing
fginort:   fronting
fginorv:   forgiving
fginorw:   frowning
fginotu:   outfitting
fginoty:   notifying
fginpty:   typifying
fginrtu:   fruiting
fginrty:   nitrifying
fglnoru:   furlong
fhilrty:   thriftily
fhinrtu:   unthrift
fhiortw:   forthwith
fhlmotu:   mouthful
fhlnrtu:   untruthful
fhlotuy:   youthfully, youthful
fhlrtuy:   truthfully, hurtfully
fiklort:   forklift
filnrtu:   unfruitful
filoprt:   portfolio
filptuy:   pitifully
filrtuy:   fruitfully
fimnoru:   uniform
fimnrty:   infirmity
fimorty:   mortify
finoprt:   footprint
finortu:   fruition
fiortuy:   fortuity
flmnoru:   mournful
fnoprtu:   upfront
ghiklnu:   hulking
ghiknou:   unhooking
ghikntu:   unthinking
ghilmty:   mightily
ghilnou:   hulloing
ghilnow:   howling, hollowing
ghilnpt:   plighting
ghilnrt:   thrilling
ghilnru:   hurling
ghilnrw:   whirling
ghilntw:   whittling
ghilnty:   nightly
ghilnwy:   whiningly
ghilopy:   philology
ghilrty:   rightly
ghimnpu:   humping
ghimnry:   rhyming
ghinopw:   whopping, whooping
ghinort:   thronging
ghinoru:   roughing
ghinorw:   whoring
ghinotu:   toughing
ghinotw:   nightgown
ghinrtu:   hurting
ghinrtv:   thriving
ghinrtw:   writhing
ghinruy:   hurrying
ghiortu:   outright
ghiprtu:   upright
ghlmoty:   mythology
ghlnopy:   phonology
ghloruy:   roughly
ghlotuy:   toughly
ghoprtu:   throughput
ghortuw:   wrought, outgrowth
ghortuy:   yoghourt
gijlnot:   jolting
gijmnpu:   jumping
giklnpu:   plunking
giklnru:   lurking, knurling
giklnrw:   wrinkling
giklntw:   twinkling
giklorw:   grillwork
giknorw:   working
giknouw:   unknowing
giknouy:   unyoking
giknqru:   quirking
gilmnot:   mottling, molting
gilmnpu:   plumping, pluming, lumping
gilmnpy:   implying
gilmnuz:   muzzling
gilnopr:   prolonging
gilnopt:   toppling, plotting, piloting
gilnort:   trolling
gilnoru:   unrolling
gilnorw:   growling
gilnory:   glorying
gilnotu:   outlining, guillotining
gilnovy:   lovingly
gilnowy:   yowling, glowingly
gilnprt:   tripling
gilnpru:   purpling, purling
gilnpry:   pryingly, grippingly
gilnpty:   pityingly
gilnpuz:   puzzling
gilnqtu:   quilting
gilnrtw:   twirling
gilnrty:   tryingly
gilntuz:   utilizing
gilntvy:   invitingly
gilntwy:   wittingly
gilnuwy:   unwillingly
gilorty:   trilogy
gilorvy:   virology
gilrtuy:   liturgy
gimnopr:   romping
gimnort:   motoring, monitoring
gimnoru:   rumoring, mourning
gimnorw:   worming, ringworm
gimnotu:   munitioning, mounting
gimnotv:   vomiting
gimnouv:   unmoving
gimnowy:   wyoming
gimnprt:   imprinting
gimnpru:   umpiring, grumping
gimnptu:   imputing
gimntuy:   mutinying
ginoprt:   trooping, proportioning, portioning, porting
ginopru:   proroguing, pouring, grouping
ginoprv:   proving
ginoptu:   pouting, outputting, gunpoint
ginoptv:   pivoting
ginoqtu:   quoting
ginortu:   tutoring, touring, torturing, routing, outrunning, grouting
ginorwy:   worrying
ginotuv:   outvoting
ginotuw:   outwitting
ginprtu:   rupturing, irrupting
ginptuy:   unpitying, puttying
ginrtvy:   virginity
glnorwy:   wrongly
glnotuy:   gluttony
gnopruw:   grownup
gnortuw:   outgrown
hiknotu:   outthink
hilmnot:   monolith, millionth
hilmtuy:   humility
hilnort:   trillionth
hilnotz:   zillionth
hiloprw:   whirlpool, whippoorwill
himortu:   thorium
himotvz:   mitzvoth
himprtu:   triumph
hiortwz:   horowitz
hlmnoty:   monthly
ijlmpuy:   jumpily
ijlnoqu:   jonquil
ijlnoty:   jointly
iklmruy:   murkily
iklnrwy:   wrinkly
iklqruy:   quirkily
ilmnopu:   polonium, monopolium
ilmortu:   turmoil
ilmptuy:   multiply
ilnopru:   purloin
ilnoptu:   pollution
ilnopvy:   polyvinyl
ilnoqtu:   quintillion
ilnotuv:   involution
iloqrtu:   loquitur
imnoprt:   promotion
imnorty:   monitory, minority
imnptuy:   impunity
imoprtu:   impromptu
imprtuy:   impurity
inoprtu:   printout, irruption
inoqrtu:   quintroon
knoprty:   krypton
lmoprty:   promptly
loprtuy:   poultry
mnoprty:   promontory
